State,District,Level,Name,TRU,No_HH_Head,TOT_P,TOT_M,TOT_F
0,0,India,India,Total,41694863,201378372,103535314,97843058
0,0,India,India,Rural,31803775,153850848,79118287,74732561
0,0,India,India,Urban,9891088,47527524,24417027,23110497
1,0,State,JAMMU & KASHMIR,Total,183020,924991,486232,438759
1,0,State,JAMMU & KASHMIR,Rural,149536,751026,392981,358045
1,0,State,JAMMU & KASHMIR,Urban,33484,173965,93251,80714
1,1,DISTRICT,Kupwara,Total,101,1048,1046,2
1,1,DISTRICT,Kupwara,Rural,63,872,870,2
1,1,DISTRICT,Kupwara,Urban,38,176,176,0
1,2,DISTRICT,Badgam,Total,14,368,343,25
1,2,DISTRICT,Badgam,Rural,1,86,78,8
1,2,DISTRICT,Badgam,Urban,13,282,265,17
1,3,DISTRICT,Leh(Ladakh),Total,40,488,444,44
1,3,DISTRICT,Leh(Ladakh),Rural,14,108,89,19
1,3,DISTRICT,Leh(Ladakh),Urban,26,380,355,25
1,4,DISTRICT,Kargil,Total,4,18,12,6
1,4,DISTRICT,Kargil,Rural,2,10,5,5
1,4,DISTRICT,Kargil,Urban,2,8,7,1
1,5,DISTRICT,Punch,Total,112,556,406,150
1,5,DISTRICT,Punch,Rural,59,278,248,30
1,5,DISTRICT,Punch,Urban,53,278,158,120
1,6,DISTRICT,Rajouri,Total,10787,48157,25170,22987
1,6,DISTRICT,Rajouri,Rural,10488,46141,23907,22234
1,6,DISTRICT,Rajouri,Urban,299,2016,1263,753
1,7,DISTRICT,Kathua,Total,27744,141224,74644,66580
1,7,DISTRICT,Kathua,Rural,23560,119693,63321,56372
1,7,DISTRICT,Kathua,Urban,4184,21531,11323,10208
1,8,DISTRICT,Baramula,Total,86,1476,1451,25
1,8,DISTRICT,Baramula,Rural,75,323,304,19
1,8,DISTRICT,Baramula,Urban,11,1153,1147,6
1,9,DISTRICT,Bandipore,Total,23,392,375,17
1,9,DISTRICT,Bandipore,Rural,4,105,105,0
1,9,DISTRICT,Bandipore,Urban,19,287,270,17
1,10,DISTRICT,Srinagar,Total,59,1068,995,73
1,10,DISTRICT,Srinagar,Rural,0,0,0,0
1,10,DISTRICT,Srinagar,Urban,59,1068,995,73
1,11,DISTRICT,Ganderbal,Total,7,117,105,12
1,11,DISTRICT,Ganderbal,Rural,7,85,73,12
1,11,DISTRICT,Ganderbal,Urban,0,32,32,0
1,12,DISTRICT,Pulwama,Total,15,402,397,5
1,12,DISTRICT,Pulwama,Rural,3,52,48,4
1,12,DISTRICT,Pulwama,Urban,12,350,349,1
1,13,DISTRICT,Shupiyan,Total,0,43,43,0
1,13,DISTRICT,Shupiyan,Rural,0,5,5,0
1,13,DISTRICT,Shupiyan,Urban,0,38,38,0
1,14,DISTRICT,Anantnag,Total,33,1826,1811,15
1,14,DISTRICT,Anantnag,Rural,19,1383,1371,12
1,14,DISTRICT,Anantnag,Urban,14,443,440,3
1,15,DISTRICT,Kulgam,Total,3,21,11,10
1,15,DISTRICT,Kulgam,Rural,3,18,8,10
1,15,DISTRICT,Kulgam,Urban,0,3,3,0
1,16,DISTRICT,Doda,Total,10531,53408,27209,26199
1,16,DISTRICT,Doda,Rural,10290,52339,26659,25680
1,16,DISTRICT,Doda,Urban,241,1069,550,519
1,17,DISTRICT,Ramban,Total,2659,13920,7168,6752
1,17,DISTRICT,Ramban,Rural,2560,13402,6892,6510
1,17,DISTRICT,Ramban,Urban,99,518,276,242
1,18,DISTRICT,Kishtwar,Total,2813,14307,7322,6985
1,18,DISTRICT,Kishtwar,Rural,2763,14020,7163,6857
1,18,DISTRICT,Kishtwar,Urban,50,287,159,128
1,19,DISTRICT,Udhampur,Total,24500,138569,72093,66476
1,19,DISTRICT,Udhampur,Rural,21517,122742,63846,58896
1,19,DISTRICT,Udhampur,Urban,2983,15827,8247,7580
1,20,DISTRICT,Reasi,Total,6818,37757,19657,18100
1,20,DISTRICT,Reasi,Rural,5979,33232,17292,15940
1,20,DISTRICT,Reasi,Urban,839,4525,2365,2160
1,21,DISTRICT,Jammu,Total,77683,377991,197610,180381
1,21,DISTRICT,Jammu,Rural,55968,268098,140062,128036
1,21,DISTRICT,Jammu,Urban,21715,109893,57548,52345
1,22,DISTRICT,Samba,Total,18988,91835,47920,43915
1,22,DISTRICT,Samba,Rural,16161,78034,40635,37399
1,22,DISTRICT,Samba,Urban,2827,13801,7285,6516
2,0,State,HIMACHAL PRADESH,Total,358212,1729252,876300,852952
2,0,State,HIMACHAL PRADESH,Rural,329620,1606535,812072,794463
2,0,State,HIMACHAL PRADESH,Urban,28592,122717,64228,58489
2,23,DISTRICT,Chamba,Total,21197,111690,56154,55536
2,23,DISTRICT,Chamba,Rural,19883,105635,53144,52491
2,23,DISTRICT,Chamba,Urban,1314,6055,3010,3045
2,24,DISTRICT,Kangra,Total,69493,319385,159697,159688
2,24,DISTRICT,Kangra,Rural,66253,304802,152186,152616
2,24,DISTRICT,Kangra,Urban,3240,14583,7511,7072
2,25,DISTRICT,Lahul & Spiti,Total,462,2235,1154,1081
2,25,DISTRICT,Lahul & Spiti,Rural,462,2235,1154,1081
2,25,DISTRICT,Lahul & Spiti,Urban,0,0,0,0
2,26,DISTRICT,Kullu,Total,25279,122659,62686,59973
2,26,DISTRICT,Kullu,Rural,23673,115514,58981,56533
2,26,DISTRICT,Kullu,Urban,1606,7145,3705,3440
2,27,DISTRICT,Mandi,Total,62033,293739,147250,146489
2,27,DISTRICT,Mandi,Rural,59031,280580,140605,139975
2,27,DISTRICT,Mandi,Urban,3002,13159,6645,6514
2,28,DISTRICT,Hamirpur,Total,24933,109256,53727,55529
2,28,DISTRICT,Hamirpur,Rural,23637,103541,50806,52735
2,28,DISTRICT,Hamirpur,Urban,1296,5715,2921,2794
2,29,DISTRICT,Una,Total,23743,115491,58601,56890
2,29,DISTRICT,Una,Rural,22264,108046,54768,53278
2,29,DISTRICT,Una,Urban,1479,7445,3833,3612
2,30,DISTRICT,Bilaspur,Total,20444,98989,50271,48718
2,30,DISTRICT,Bilaspur,Rural,19281,93678,47550,46128
2,30,DISTRICT,Bilaspur,Urban,1163,5311,2721,2590
2,31,DISTRICT,Solan,Total,32909,164536,85482,79054
2,31,DISTRICT,Solan,Rural,29170,148800,76902,71898
2,31,DISTRICT,Solan,Urban,3739,15736,8580,7156
2,32,DISTRICT,Sirmaur,Total,28676,160745,83017,77728
2,32,DISTRICT,Sirmaur,Rural,26262,149719,77367,72352
2,32,DISTRICT,Sirmaur,Urban,2414,11026,5650,5376
2,33,DISTRICT,Shimla,Total,45607,215777,110828,104949
2,33,DISTRICT,Shimla,Rural,36268,179235,91176,88059
2,33,DISTRICT,Shimla,Urban,9339,36542,19652,16890
2,34,DISTRICT,Kinnaur,Total,3436,14750,7433,7317
2,34,DISTRICT,Kinnaur,Rural,3436,14750,7433,7317
2,34,DISTRICT,Kinnaur,Urban,0,0,0,0
3,0,State,PUNJAB,Total,1717888,8860179,4639875,4220304
3,0,State,PUNJAB,Rural,1253212,6496986,3396329,3100657
3,0,State,PUNJAB,Urban,464676,2363193,1243546,1119647
3,35,DISTRICT,Gurdaspur,Total,110193,580576,304894,275682
3,35,DISTRICT,Gurdaspur,Rural,81963,435930,228541,207389
3,35,DISTRICT,Gurdaspur,Urban,28230,144646,76353,68293
3,36,DISTRICT,Kapurthala ,Total,53920,276707,143901,132806
3,36,DISTRICT,Kapurthala ,Rural,40915,212013,110167,101846
3,36,DISTRICT,Kapurthala ,Urban,13005,64694,33734,30960
3,37,DISTRICT,Jalandhar,Total,172545,854444,442124,412320
3,37,DISTRICT,Jalandhar,Rural,103108,515342,264466,250876
3,37,DISTRICT,Jalandhar,Urban,69437,339102,177658,161444
3,38,DISTRICT,Hoshiarpur,Total,114289,557504,284322,273182
3,38,DISTRICT,Hoshiarpur,Rural,95405,465037,236295,228742
3,38,DISTRICT,Hoshiarpur,Urban,18884,92467,48027,44440
3,39,DISTRICT,Shahid Bhagat Singh Nagar ,Total,52843,260284,133035,127249
3,39,DISTRICT,Shahid Bhagat Singh Nagar ,Rural,43160,212889,108494,104395
3,39,DISTRICT,Shahid Bhagat Singh Nagar ,Urban,9683,47395,24541,22854
3,40,DISTRICT,Fatehgarh Sahib,Total,37264,192493,101882,90611
3,40,DISTRICT,Fatehgarh Sahib,Rural,29596,154570,81690,72880
3,40,DISTRICT,Fatehgarh Sahib,Urban,7668,37923,20192,17731
3,41,DISTRICT,Ludhiana,Total,180261,923358,487839,435519
3,41,DISTRICT,Ludhiana,Rural,107729,559471,294159,265312
3,41,DISTRICT,Ludhiana,Urban,72532,363887,193680,170207
3,42,DISTRICT,Moga,Total,69553,363417,192418,170999
3,42,DISTRICT,Moga,Rural,58823,307098,162624,144474
3,42,DISTRICT,Moga,Urban,10730,56319,29794,26525
3,43,DISTRICT,Firozpur,Total,161552,855726,445461,410265
3,43,DISTRICT,Firozpur,Rural,134449,709922,369036,340886
3,43,DISTRICT,Firozpur,Urban,27103,145804,76425,69379
3,44,DISTRICT,Muktsar,Total,73699,381554,200473,181081
3,44,DISTRICT,Muktsar,Rural,57342,295179,155136,140043
3,44,DISTRICT,Muktsar,Urban,16357,86375,45337,41038
3,45,DISTRICT,Faridkot,Total,46983,240328,126567,113761
3,45,DISTRICT,Faridkot,Rural,33582,171199,90303,80896
3,45,DISTRICT,Faridkot,Urban,13401,69129,36264,32865
3,46,DISTRICT,Bathinda,Total,88109,450473,236936,213537
3,46,DISTRICT,Bathinda,Rural,63068,321533,169244,152289
3,46,DISTRICT,Bathinda,Urban,25041,128940,67692,61248
3,47,DISTRICT,Mansa,Total,51072,258878,136311,122567
3,47,DISTRICT,Mansa,Rural,43053,217553,114644,102909
3,47,DISTRICT,Mansa,Urban,8019,41325,21667,19658
3,48,DISTRICT,Patiala,Total,89526,465359,244503,220856
3,48,DISTRICT,Patiala,Rural,66894,348587,183424,165163
3,48,DISTRICT,Patiala,Urban,22632,116772,61079,55693
3,49,DISTRICT,Amritsar ,Total,144287,770864,405977,364887
3,49,DISTRICT,Amritsar ,Rural,84857,464984,244254,220730
3,49,DISTRICT,Amritsar ,Urban,59430,305880,161723,144157
3,50,DISTRICT,Tarn Taran,Total,67487,377468,198715,178753
3,50,DISTRICT,Tarn Taran,Rural,60800,339558,178817,160741
3,50,DISTRICT,Tarn Taran,Urban,6687,37910,19898,18012
3,51,DISTRICT,Rupnagar,Total,35218,180905,94334,86571
3,51,DISTRICT,Rupnagar,Rural,26771,138597,72349,66248
3,51,DISTRICT,Rupnagar,Urban,8447,42308,21985,20323
3,52,DISTRICT,Sahibzada Ajit Singh Nagar,Total,42415,216231,114383,101848
3,52,DISTRICT,Sahibzada Ajit Singh Nagar,Rural,25541,132713,70327,62386
3,52,DISTRICT,Sahibzada Ajit Singh Nagar,Urban,16874,83518,44056,39462
3,53,DISTRICT,Sangrur,Total,89585,461609,244231,217378
3,53,DISTRICT,Sangrur,Rural,70334,361376,191723,169653
3,53,DISTRICT,Sangrur,Urban,19251,100233,52508,47725
3,54,DISTRICT,Barnala,Total,37087,192001,101569,90432
3,54,DISTRICT,Barnala,Rural,25822,133435,70636,62799
3,54,DISTRICT,Barnala,Urban,11265,58566,30933,27633
4,0,State,CHANDIGARH,Total,40694,199086,106356,92730
4,0,State,CHANDIGARH,Rural,1130,4974,2776,2198
4,0,State,CHANDIGARH,Urban,39564,194112,103580,90532
4,55,DISTRICT,Chandigarh,Total,40694,199086,106356,92730
4,55,DISTRICT,Chandigarh,Rural,1130,4974,2776,2198
4,55,DISTRICT,Chandigarh,Urban,39564,194112,103580,90532
5,0,State,UTTARAKHAND,Total,363305,1892516,968586,923930
5,0,State,UTTARAKHAND,Rural,286460,1496665,761103,735562
5,0,State,UTTARAKHAND,Urban,76845,395851,207483,188368
5,56,DISTRICT,Uttarkashi,Total,15657,80567,40833,39734
5,56,DISTRICT,Uttarkashi,Rural,14868,76875,38936,37939
5,56,DISTRICT,Uttarkashi,Urban,789,3692,1897,1795
5,57,DISTRICT,Chamoli,Total,16276,79317,39718,39599
5,57,DISTRICT,Chamoli,Rural,13875,68000,33757,34243
5,57,DISTRICT,Chamoli,Urban,2401,11317,5961,5356
5,58,DISTRICT,Rudraprayag,Total,9460,47679,23585,24094
5,58,DISTRICT,Rudraprayag,Rural,9166,46279,22823,23456
5,58,DISTRICT,Rudraprayag,Urban,294,1400,762,638
5,59,DISTRICT,Tehri Garhwal,Total,19463,102130,50371,51759
5,59,DISTRICT,Tehri Garhwal,Rural,17859,94628,46327,48301
5,59,DISTRICT,Tehri Garhwal,Urban,1604,7502,4044,3458
5,60,DISTRICT,Dehradun,Total,42436,228901,120430,108471
5,60,DISTRICT,Dehradun,Rural,20853,119123,62548,56575
5,60,DISTRICT,Dehradun,Urban,21583,109778,57882,51896
5,61,DISTRICT,Garhwal,Total,25278,122361,59842,62519
5,61,DISTRICT,Garhwal,Rural,22672,109576,53278,56298
5,61,DISTRICT,Garhwal,Urban,2606,12785,6564,6221
5,62,DISTRICT,Pithoragarh,Total,25460,120378,60111,60267
5,62,DISTRICT,Pithoragarh,Rural,22999,109541,54528,55013
5,62,DISTRICT,Pithoragarh,Urban,2461,10837,5583,5254
5,63,DISTRICT,Bageshwar,Total,14588,72061,35623,36438
5,63,DISTRICT,Bageshwar,Rural,14142,69842,34489,35353
5,63,DISTRICT,Bageshwar,Urban,446,2219,1134,1085
5,64,DISTRICT,Almora,Total,30220,150995,72695,78300
5,64,DISTRICT,Almora,Rural,28122,140931,67619,73312
5,64,DISTRICT,Almora,Urban,2098,10064,5076,4988
5,65,DISTRICT,Champawat,Total,9088,47383,24188,23195
5,65,DISTRICT,Champawat,Rural,7976,41725,21262,20463
5,65,DISTRICT,Champawat,Urban,1112,5658,2926,2732
5,66,DISTRICT,Nainital,Total,36345,191206,98824,92382
5,66,DISTRICT,Nainital,Rural,25915,137906,71137,66769
5,66,DISTRICT,Nainital,Urban,10430,53300,27687,25613
5,67,DISTRICT,Udham Singh Nagar,Total,44324,238264,124385,113879
5,67,DISTRICT,Udham Singh Nagar,Rural,32711,174919,91263,83656
5,67,DISTRICT,Udham Singh Nagar,Urban,11613,63345,33122,30223
5,68,DISTRICT,Hardwar,Total,74710,411274,217981,193293
5,68,DISTRICT,Hardwar,Rural,55302,307320,163136,144184
5,68,DISTRICT,Hardwar,Urban,19408,103954,54845,49109
6,0,State,HARYANA,Total,992096,5113615,2709656,2403959
6,0,State,HARYANA,Rural,723369,3720109,1973294,1746815
6,0,State,HARYANA,Urban,268727,1393506,736362,657144
6,69,DISTRICT,Panchkula,Total,20375,101830,53868,47962
6,69,DISTRICT,Panchkula,Rural,9926,51484,27259,24225
6,69,DISTRICT,Panchkula,Urban,10449,50346,26609,23737
6,70,DISTRICT,Ambala,Total,57931,296246,156874,139372
6,70,DISTRICT,Ambala,Rural,40260,208224,110736,97488
6,70,DISTRICT,Ambala,Urban,17671,88022,46138,41884
6,71,DISTRICT,Yamunanagar,Total,60283,306743,163200,143543
6,71,DISTRICT,Yamunanagar,Rural,45686,233513,124252,109261
6,71,DISTRICT,Yamunanagar,Urban,14597,73230,38948,34282
6,72,DISTRICT,Kurukshetra,Total,42760,215128,113311,101817
6,72,DISTRICT,Kurukshetra,Rural,34423,173560,91213,82347
6,72,DISTRICT,Kurukshetra,Urban,8337,41568,22098,19470
6,73,DISTRICT,Kaithal,Total,49160,247513,131486,116027
6,73,DISTRICT,Kaithal,Rural,40417,202878,107815,95063
6,73,DISTRICT,Kaithal,Urban,8743,44635,23671,20964
6,74,DISTRICT,Karnal,Total,67102,339604,179681,159923
6,74,DISTRICT,Karnal,Rural,51233,259520,137535,121985
6,74,DISTRICT,Karnal,Urban,15869,80084,42146,37938
6,75,DISTRICT,Panipat,Total,40661,206213,109695,96518
6,75,DISTRICT,Panipat,Rural,25594,130212,69446,60766
6,75,DISTRICT,Panipat,Urban,15067,76001,40249,35752
6,76,DISTRICT,Sonipat,Total,52701,269935,144516,125419
6,76,DISTRICT,Sonipat,Rural,37982,192682,103444,89238
6,76,DISTRICT,Sonipat,Urban,14719,77253,41072,36181
6,77,DISTRICT,Jind,Total,55044,282351,150940,131411
6,77,DISTRICT,Jind,Rural,44949,228804,122596,106208
6,77,DISTRICT,Jind,Urban,10095,53547,28344,25203
6,78,DISTRICT,Fatehabad,Total,54791,284357,149111,135246
6,78,DISTRICT,Fatehabad,Rural,46305,239215,125461,113754
6,78,DISTRICT,Fatehabad,Urban,8486,45142,23650,21492
6,79,DISTRICT,Sirsa,Total,74039,387381,202430,184951
6,79,DISTRICT,Sirsa,Rural,59881,312059,163211,148848
6,79,DISTRICT,Sirsa,Urban,14158,75322,39219,36103
6,80,DISTRICT,Hisar,Total,79265,408785,217338,191447
6,80,DISTRICT,Hisar,Rural,59060,302577,161528,141049
6,80,DISTRICT,Hisar,Urban,20205,106208,55810,50398
6,81,DISTRICT,Bhiwani,Total,66050,341162,181475,159687
6,81,DISTRICT,Bhiwani,Rural,53455,274877,146464,128413
6,81,DISTRICT,Bhiwani,Urban,12595,66285,35011,31274
6,82,DISTRICT,Rohtak,Total,42023,216889,115573,101316
6,82,DISTRICT,Rohtak,Rural,26474,134935,72114,62821
6,82,DISTRICT,Rohtak,Urban,15549,81954,43459,38495
6,83,DISTRICT,Jhajjar,Total,33614,170448,90856,79592
6,83,DISTRICT,Jhajjar,Rural,25963,130913,69894,61019
6,83,DISTRICT,Jhajjar,Urban,7651,39535,20962,18573
6,84,DISTRICT,Mahendragarh,Total,30819,156314,82420,73894
6,84,DISTRICT,Mahendragarh,Rural,27021,136311,72014,64297
6,84,DISTRICT,Mahendragarh,Urban,3798,20003,10406,9597
6,85,DISTRICT,Rewari,Total,36580,182606,95571,87035
6,85,DISTRICT,Rewari,Rural,28391,140637,73617,67020
6,85,DISTRICT,Rewari,Urban,8189,41969,21954,20015
6,86,DISTRICT,Gurgaon,Total,38354,197937,104332,93605
6,86,DISTRICT,Gurgaon,Rural,17515,90113,47249,42864
6,86,DISTRICT,Gurgaon,Urban,20839,107824,57083,50741
6,87,DISTRICT,Mewat ,Total,13079,75251,39743,35508
6,87,DISTRICT,Mewat ,Rural,9983,57238,30312,26926
6,87,DISTRICT,Mewat ,Urban,3096,18013,9431,8582
6,88,DISTRICT,Faridabad,Total,42626,223799,119495,104304
6,88,DISTRICT,Faridabad,Rural,13051,71464,37920,33544
6,88,DISTRICT,Faridabad,Urban,29575,152335,81575,70760
6,89,DISTRICT,Palwal ,Total,34839,203123,107741,95382
6,89,DISTRICT,Palwal ,Rural,25800,148893,79214,69679
6,89,DISTRICT,Palwal ,Urban,9039,54230,28527,25703
7,0,State,NCT OF DELHI,Total,527307,2812309,1488800,1323509
7,0,State,NCT OF DELHI,Rural,14984,82183,43818,38365
7,0,State,NCT OF DELHI,Urban,512323,2730126,1444982,1285144
7,90,DISTRICT,North West,Total,129794,697237,371546,325691
7,90,DISTRICT,North West,Rural,9210,50468,26996,23472
7,90,DISTRICT,North West,Urban,120584,646769,344550,302219
7,91,DISTRICT,North,Total,31586,165663,87007,78656
7,91,DISTRICT,North,Rural,219,1238,665,573
7,91,DISTRICT,North,Urban,31367,164425,86342,78083
7,92,DISTRICT,North East,Total,66194,373758,197059,176699
7,92,DISTRICT,North East,Rural,460,2569,1360,1209
7,92,DISTRICT,North East,Urban,65734,371189,195699,175490
7,93,DISTRICT,East,Total,52025,281422,148019,133403
7,93,DISTRICT,East,Rural,12,57,23,34
7,93,DISTRICT,East,Urban,52013,281365,147996,133369
7,94,DISTRICT,New Delhi,Total,6729,33245,17885,15360
7,94,DISTRICT,New Delhi,Rural,0,0,0,0
7,94,DISTRICT,New Delhi,Urban,6729,33245,17885,15360
7,95,DISTRICT,Central,Total,28225,143178,73782,69396
7,95,DISTRICT,Central,Rural,0,0,0,0
7,95,DISTRICT,Central,Urban,28225,143178,73782,69396
7,96,DISTRICT,West,Total,71879,376472,200098,176374
7,96,DISTRICT,West,Rural,225,1263,652,611
7,96,DISTRICT,West,Urban,71654,375209,199446,175763
7,97,DISTRICT,South West,Total,61374,318408,170205,148203
7,97,DISTRICT,South West,Rural,4482,24619,13060,11559
7,97,DISTRICT,South West,Urban,56892,293789,157145,136644
7,98,DISTRICT,South,Total,79501,422926,223199,199727
7,98,DISTRICT,South,Rural,376,1969,1062,907
7,98,DISTRICT,South,Urban,79125,420957,222137,198820
8,0,State,RAJASTHAN,Total,2279366,12221593,6355564,5866029
8,0,State,RAJASTHAN,Rural,1782338,9536963,4958563,4578400
8,0,State,RAJASTHAN,Urban,497028,2684630,1397001,1287629
8,99,DISTRICT,Ganganagar ,Total,142395,720412,376734,343678
8,99,DISTRICT,Ganganagar ,Rural,119029,598772,312908,285864
8,99,DISTRICT,Ganganagar ,Urban,23366,121640,63826,57814
8,100,DISTRICT,Hanumangarh,Total,94867,494189,258352,235837
8,100,DISTRICT,Hanumangarh,Rural,83775,435504,227763,207741
8,100,DISTRICT,Hanumangarh,Urban,11092,58685,30589,28096
8,101,DISTRICT,Bikaner,Total,80093,493646,259532,234114
8,101,DISTRICT,Bikaner,Rural,64105,397781,209550,188231
8,101,DISTRICT,Bikaner,Urban,15988,95865,49982,45883
8,102,DISTRICT,Churu,Total,78343,451721,235113,216608
8,102,DISTRICT,Churu,Rural,65874,376554,195938,180616
8,102,DISTRICT,Churu,Urban,12469,75167,39175,35992
8,103,DISTRICT,Jhunjhunun,Total,66531,360709,185879,174830
8,103,DISTRICT,Jhunjhunun,Rural,53176,285737,147016,138721
8,103,DISTRICT,Jhunjhunun,Urban,13355,74972,38863,36109
8,104,DISTRICT,Alwar,Total,117811,653036,342938,310098
8,104,DISTRICT,Alwar,Rural,97221,540412,283680,256732
8,104,DISTRICT,Alwar,Urban,20590,112624,59258,53366
8,105,DISTRICT,Bharatpur,Total,98038,557305,296293,261012
8,105,DISTRICT,Bharatpur,Rural,77135,436158,232180,203978
8,105,DISTRICT,Bharatpur,Urban,20903,121147,64113,57034
8,106,DISTRICT,Dhaulpur,Total,42616,245695,131875,113820
8,106,DISTRICT,Dhaulpur,Rural,35390,201991,108502,93489
8,106,DISTRICT,Dhaulpur,Urban,7226,43704,23373,20331
8,107,DISTRICT,Karauli,Total,64425,354465,189249,165216
8,107,DISTRICT,Karauli,Rural,57198,313060,167332,145728
8,107,DISTRICT,Karauli,Urban,7227,41405,21917,19488
8,108,DISTRICT,Sawai Madhopur,Total,53247,278789,146333,132456
8,108,DISTRICT,Sawai Madhopur,Rural,43997,227374,119679,107695
8,108,DISTRICT,Sawai Madhopur,Urban,9250,51415,26654,24761
8,109,DISTRICT,Dausa,Total,64619,354337,185349,168988
8,109,DISTRICT,Dausa,Rural,57938,317204,165947,151257
8,109,DISTRICT,Dausa,Urban,6681,37133,19402,17731
8,110,DISTRICT,Jaipur,Total,180142,1003302,524831,478471
8,110,DISTRICT,Jaipur,Rural,92761,529842,276330,253512
8,110,DISTRICT,Jaipur,Urban,87381,473460,248501,224959
8,111,DISTRICT,Sikar,Total,72947,418806,216523,202283
8,111,DISTRICT,Sikar,Rural,59759,339524,175322,164202
8,111,DISTRICT,Sikar,Urban,13188,79282,41201,38081
8,112,DISTRICT,Nagaur,Total,126588,699911,360451,339460
8,112,DISTRICT,Nagaur,Rural,111930,613527,316049,297478
8,112,DISTRICT,Nagaur,Urban,14658,86384,44402,41982
8,113,DISTRICT,Jodhpur,Total,105437,608024,315199,292825
8,113,DISTRICT,Jodhpur,Rural,76778,447037,232087,214950
8,113,DISTRICT,Jodhpur,Urban,28659,160987,83112,77875
8,114,DISTRICT,Jaisalmer,Total,16845,99134,52776,46358
8,114,DISTRICT,Jaisalmer,Rural,15054,89388,47555,41833
8,114,DISTRICT,Jaisalmer,Urban,1791,9746,5221,4525
8,115,DISTRICT,Barmer,Total,75383,436414,228431,207983
8,115,DISTRICT,Barmer,Rural,70524,408568,214011,194557
8,115,DISTRICT,Barmer,Urban,4859,27846,14420,13426
8,116,DISTRICT,Jalor,Total,63481,357196,185342,171854
8,116,DISTRICT,Jalor,Rural,57810,326518,169318,157200
8,116,DISTRICT,Jalor,Urban,5671,30678,16024,14654
8,117,DISTRICT,Sirohi,Total,39724,201863,104899,96964
8,117,DISTRICT,Sirohi,Rural,31483,160943,83564,77379
8,117,DISTRICT,Sirohi,Urban,8241,40920,21335,19585
8,118,DISTRICT,Pali,Total,79189,398096,203328,194768
8,118,DISTRICT,Pali,Rural,64608,321262,163602,157660
8,118,DISTRICT,Pali,Urban,14581,76834,39726,37108
8,119,DISTRICT,Ajmer,Total,91206,478027,243750,234277
8,119,DISTRICT,Ajmer,Rural,49882,256646,130764,125882
8,119,DISTRICT,Ajmer,Urban,41324,221381,112986,108395
8,120,DISTRICT,Tonk,Total,54940,287903,148110,139793
8,120,DISTRICT,Tonk,Rural,45486,235975,121388,114587
8,120,DISTRICT,Tonk,Urban,9454,51928,26722,25206
8,121,DISTRICT,Bundi,Total,42163,210788,109333,101455
8,121,DISTRICT,Bundi,Rural,33693,168317,87314,81003
8,121,DISTRICT,Bundi,Urban,8470,42471,22019,20452
8,122,DISTRICT,Bhilwara,Total,85806,407947,206332,201615
8,122,DISTRICT,Bhilwara,Rural,70666,331943,167445,164498
8,122,DISTRICT,Bhilwara,Urban,15140,76004,38887,37117
8,123,DISTRICT,Rajsamand,Total,31119,148168,74738,73430
8,123,DISTRICT,Rajsamand,Rural,25845,121784,61388,60396
8,123,DISTRICT,Rajsamand,Urban,5274,26384,13350,13034
8,124,DISTRICT,Dungarpur,Total,10991,52267,26543,25724
8,124,DISTRICT,Dungarpur,Rural,9441,44309,22523,21786
8,124,DISTRICT,Dungarpur,Urban,1550,7958,4020,3938
8,125,DISTRICT,Banswara,Total,16534,80091,40639,39452
8,125,DISTRICT,Banswara,Rural,14720,70767,35912,34855
8,125,DISTRICT,Banswara,Urban,1814,9324,4727,4597
8,126,DISTRICT,Chittaurgarh,Total,54912,250224,126748,123476
8,126,DISTRICT,Chittaurgarh,Rural,47064,212388,107367,105021
8,126,DISTRICT,Chittaurgarh,Urban,7848,37836,19381,18455
8,127,DISTRICT,Kota,Total,81896,405408,211161,194247
8,127,DISTRICT,Kota,Rural,36599,181857,94241,87616
8,127,DISTRICT,Kota,Urban,45297,223551,116920,106631
8,128,DISTRICT,Baran,Total,44607,221184,114969,106215
8,128,DISTRICT,Baran,Rural,33834,167196,87025,80171
8,128,DISTRICT,Baran,Urban,10773,53988,27944,26044
8,129,DISTRICT,Jhalawar,Total,50676,243582,125965,117617
8,129,DISTRICT,Jhalawar,Rural,43060,205764,106454,99310
8,129,DISTRICT,Jhalawar,Urban,7616,37818,19511,18307
8,130,DISTRICT,Udaipur,Total,38828,188525,97094,91431
8,130,DISTRICT,Udaipur,Rural,25624,122385,62733,59652
8,130,DISTRICT,Udaipur,Urban,13204,66140,34361,31779
8,131,DISTRICT,Pratapgarh,Total,12967,60429,30755,29674
8,131,DISTRICT,Pratapgarh,Rural,10879,50476,25676,24800
8,131,DISTRICT,Pratapgarh,Urban,2088,9953,5079,4874
9,0,State,UTTAR PRADESH,Total,7375437,41357608,21676975,19680633
9,0,State,UTTAR PRADESH,Rural,6371087,35685227,18663920,17021307
9,0,State,UTTAR PRADESH,Urban,1004350,5672381,3013055,2659326
9,132,DISTRICT,Saharanpur,Total,140246,764450,407029,357421
9,132,DISTRICT,Saharanpur,Rural,114550,627371,334256,293115
9,132,DISTRICT,Saharanpur,Urban,25696,137079,72773,64306
9,133,DISTRICT,Muzaffarnagar,Total,99154,561250,298587,262663
9,133,DISTRICT,Muzaffarnagar,Rural,80781,458494,244133,214361
9,133,DISTRICT,Muzaffarnagar,Urban,18373,102756,54454,48302
9,134,DISTRICT,Bijnor,Total,142240,787444,413872,373572
9,134,DISTRICT,Bijnor,Rural,129504,716442,376424,340018
9,134,DISTRICT,Bijnor,Urban,12736,71002,37448,33554
9,135,DISTRICT,Moradabad,Total,127998,731406,385244,346162
9,135,DISTRICT,Moradabad,Rural,101829,582700,306887,275813
9,135,DISTRICT,Moradabad,Urban,26169,148706,78357,70349
9,136,DISTRICT,Rampur,Total,54486,307936,162844,145092
9,136,DISTRICT,Rampur,Rural,49044,277838,146888,130950
9,136,DISTRICT,Rampur,Urban,5442,30098,15956,14142
9,137,DISTRICT,Jyotiba Phule Nagar,Total,56516,318001,166662,151339
9,137,DISTRICT,Jyotiba Phule Nagar,Rural,48949,276283,144700,131583
9,137,DISTRICT,Jyotiba Phule Nagar,Urban,7567,41718,21962,19756
9,138,DISTRICT,Meerut,Total,109151,624149,334198,289951
9,138,DISTRICT,Meerut,Rural,59978,347463,185897,161566
9,138,DISTRICT,Meerut,Urban,49173,276686,148301,128385
9,139,DISTRICT,Baghpat,Total,25720,149060,79920,69140
9,139,DISTRICT,Baghpat,Rural,21750,125954,67707,58247
9,139,DISTRICT,Baghpat,Urban,3970,23106,12213,10893
9,140,DISTRICT,Ghaziabad,Total,137531,773463,412750,360713
9,140,DISTRICT,Ghaziabad,Rural,50051,287708,153686,134022
9,140,DISTRICT,Ghaziabad,Urban,87480,485755,259064,226691
9,141,DISTRICT,Gautam Buddha Nagar,Total,38807,216105,115438,100667
9,141,DISTRICT,Gautam Buddha Nagar,Rural,21987,129086,68551,60535
9,141,DISTRICT,Gautam Buddha Nagar,Urban,16820,87019,46887,40132
9,142,DISTRICT,Bulandshahr ,Total,125349,725600,384743,340857
9,142,DISTRICT,Bulandshahr ,Rural,104606,606673,321833,284840
9,142,DISTRICT,Bulandshahr ,Urban,20743,118927,62910,56017
9,143,DISTRICT,Aligarh,Total,128046,755254,402483,352771
9,143,DISTRICT,Aligarh,Rural,95753,564827,301494,263333
9,143,DISTRICT,Aligarh,Urban,32293,190427,100989,89438
9,144,DISTRICT,Mahamaya Nagar,Total,65204,387554,207170,180384
9,144,DISTRICT,Mahamaya Nagar,Rural,53504,318235,170204,148031
9,144,DISTRICT,Mahamaya Nagar,Urban,11700,69319,36966,32353
9,145,DISTRICT,Mathura,Total,85328,506580,271295,235285
9,145,DISTRICT,Mathura,Rural,67937,400917,214919,185998
9,145,DISTRICT,Mathura,Urban,17391,105663,56376,49287
9,146,DISTRICT,Agra,Total,159652,991325,531641,459684
9,146,DISTRICT,Agra,Rural,81198,505140,270558,234582
9,146,DISTRICT,Agra,Urban,78454,486185,261083,225102
9,147,DISTRICT,Firozabad,Total,80896,473890,253288,220602
9,147,DISTRICT,Firozabad,Rural,56908,333275,178450,154825
9,147,DISTRICT,Firozabad,Urban,23988,140615,74838,65777
9,148,DISTRICT,Mainpuri,Total,62955,368206,196507,171699
9,148,DISTRICT,Mainpuri,Rural,54723,319437,170802,148635
9,148,DISTRICT,Mainpuri,Urban,8232,48769,25705,23064
9,149,DISTRICT,Budaun,Total,107606,622526,332920,289606
9,149,DISTRICT,Budaun,Rural,95718,553486,296604,256882
9,149,DISTRICT,Budaun,Urban,11888,69040,36316,32724
9,150,DISTRICT,Bareilly,Total,99725,557150,295964,261186
9,150,DISTRICT,Bareilly,Rural,79051,442422,235417,207005
9,150,DISTRICT,Bareilly,Urban,20674,114728,60547,54181
9,151,DISTRICT,Pilibhit,Total,62364,333558,176436,157122
9,151,DISTRICT,Pilibhit,Rural,56968,304273,161070,143203
9,151,DISTRICT,Pilibhit,Urban,5396,29285,15366,13919
9,152,DISTRICT,Shahjahanpur,Total,98999,532673,285280,247393
9,152,DISTRICT,Shahjahanpur,Rural,89616,479352,257180,222172
9,152,DISTRICT,Shahjahanpur,Urban,9383,53321,28100,25221
9,153,DISTRICT,Kheri,Total,211001,1061782,559240,502542
9,153,DISTRICT,Kheri,Rural,203056,1019387,536713,482674
9,153,DISTRICT,Kheri,Urban,7945,42395,22527,19868
9,154,DISTRICT,Sitapur,Total,274014,1446427,767033,679394
9,154,DISTRICT,Sitapur,Rural,264963,1393577,738958,654619
9,154,DISTRICT,Sitapur,Urban,9051,52850,28075,24775
9,155,DISTRICT,Hardoi,Total,241094,1274505,685223,589282
9,155,DISTRICT,Hardoi,Rural,229828,1209207,650259,558948
9,155,DISTRICT,Hardoi,Urban,11266,65298,34964,30334
9,156,DISTRICT,Unnao,Total,186217,948588,494487,454101
9,156,DISTRICT,Unnao,Rural,172185,873572,455745,417827
9,156,DISTRICT,Unnao,Urban,14032,75016,38742,36274
9,157,DISTRICT,Lucknow,Total,186479,948294,498799,449495
9,157,DISTRICT,Lucknow,Rural,117474,597272,314172,283100
9,157,DISTRICT,Lucknow,Urban,69005,351022,184627,166395
9,158,DISTRICT,Rae Bareli,Total,198249,1030367,526735,503632
9,158,DISTRICT,Rae Bareli,Rural,190018,984420,502718,481702
9,158,DISTRICT,Rae Bareli,Urban,8231,45947,24017,21930
9,159,DISTRICT,Farrukhabad,Total,54649,312712,168009,144703
9,159,DISTRICT,Farrukhabad,Rural,45011,256428,137656,118772
9,159,DISTRICT,Farrukhabad,Urban,9638,56284,30353,25931
9,160,DISTRICT,Kannauj,Total,55713,309980,166454,143526
9,160,DISTRICT,Kannauj,Rural,50114,277813,149428,128385
9,160,DISTRICT,Kannauj,Urban,5599,32167,17026,15141
9,161,DISTRICT,Etawah,Total,69634,388283,208731,179552
9,161,DISTRICT,Etawah,Rural,59259,328659,177031,151628
9,161,DISTRICT,Etawah,Urban,10375,59624,31700,27924
9,162,DISTRICT,Auraiya,Total,71898,391622,211413,180209
9,162,DISTRICT,Auraiya,Rural,64745,350574,189533,161041
9,162,DISTRICT,Auraiya,Urban,7153,41048,21880,19168
9,163,DISTRICT,Kanpur Dehat,Total,87099,460544,248195,212349
9,163,DISTRICT,Kanpur Dehat,Rural,81927,431972,232978,198994
9,163,DISTRICT,Kanpur Dehat,Urban,5172,28572,15217,13355
9,164,DISTRICT,Kanpur Nagar,Total,159471,816754,439603,377151
9,164,DISTRICT,Kanpur Nagar,Rural,84605,437722,235029,202693
9,164,DISTRICT,Kanpur Nagar,Urban,74866,379032,204574,174458
9,165,DISTRICT,Jalaun ,Total,81868,468178,252588,215590
9,165,DISTRICT,Jalaun ,Rural,65612,375126,202852,172274
9,165,DISTRICT,Jalaun ,Urban,16256,93052,49736,43316
9,166,DISTRICT,Jhansi,Total,104962,562505,297386,265119
9,166,DISTRICT,Jhansi,Rural,71150,374245,197846,176399
9,166,DISTRICT,Jhansi,Urban,33812,188260,99540,88720
9,167,DISTRICT,Lalitpur,Total,45436,240519,126325,114194
9,167,DISTRICT,Lalitpur,Rural,40683,215108,113012,102096
9,167,DISTRICT,Lalitpur,Urban,4753,25411,13313,12098
9,168,DISTRICT,Hamirpur,Total,45356,241198,130269,110929
9,168,DISTRICT,Hamirpur,Rural,37647,198693,107472,91221
9,168,DISTRICT,Hamirpur,Urban,7709,42505,22797,19708
9,169,DISTRICT,Mahoba,Total,39514,220898,117389,103509
9,169,DISTRICT,Mahoba,Rural,33730,188781,100318,88463
9,169,DISTRICT,Mahoba,Urban,5784,32117,17071,15046
9,170,DISTRICT,Banda,Total,70776,387855,208184,179671
9,170,DISTRICT,Banda,Rural,63023,344057,184929,159128
9,170,DISTRICT,Banda,Urban,7753,43798,23255,20543
9,171,DISTRICT,Chitrakoot,Total,47683,266655,141379,125276
9,171,DISTRICT,Chitrakoot,Rural,44287,246900,131064,115836
9,171,DISTRICT,Chitrakoot,Urban,3396,19755,10315,9440
9,172,DISTRICT,Fatehpur,Total,122460,651480,342892,308588
9,172,DISTRICT,Fatehpur,Rural,113680,604239,317963,286276
9,172,DISTRICT,Fatehpur,Urban,8780,47241,24929,22312
9,173,DISTRICT,Pratapgarh,Total,126508,709252,351054,358198
9,173,DISTRICT,Pratapgarh,Rural,123509,691199,341905,349294
9,173,DISTRICT,Pratapgarh,Urban,2999,18053,9149,8904
9,174,DISTRICT,Kaushambi,Total,107200,555397,291303,264094
9,174,DISTRICT,Kaushambi,Rural,102691,532594,279256,253338
9,174,DISTRICT,Kaushambi,Urban,4509,22803,12047,10756
9,175,DISTRICT,Allahabad ,Total,232317,1309851,687076,622775
9,175,DISTRICT,Allahabad ,Rural,197225,1108075,579398,528677
9,175,DISTRICT,Allahabad ,Urban,35092,201776,107678,94098
9,176,DISTRICT,Bara Banki,Total,172380,864559,453168,411391
9,176,DISTRICT,Bara Banki,Rural,166479,833812,436762,397050
9,176,DISTRICT,Bara Banki,Urban,5901,30747,16406,14341
9,177,DISTRICT,Faizabad,Total,104670,555047,281284,273763
9,177,DISTRICT,Faizabad,Rural,98080,519511,262829,256682
9,177,DISTRICT,Faizabad,Urban,6590,35536,18455,17081
9,178,DISTRICT,Ambedkar Nagar,Total,98063,591125,298240,292885
9,178,DISTRICT,Ambedkar Nagar,Rural,93241,562930,283815,279115
9,178,DISTRICT,Ambedkar Nagar,Urban,4822,28195,14425,13770
9,179,DISTRICT,Sultanpur,Total,151608,851587,431438,420149
9,179,DISTRICT,Sultanpur,Rural,148374,832547,421560,410987
9,179,DISTRICT,Sultanpur,Urban,3234,19040,9878,9162
9,180,DISTRICT,Bahraich,Total,95269,509307,270226,239081
9,180,DISTRICT,Bahraich,Rural,92624,494161,262362,231799
9,180,DISTRICT,Bahraich,Urban,2645,15146,7864,7282
9,181,DISTRICT,Shrawasti,Total,36361,189334,101785,87549
9,181,DISTRICT,Shrawasti,Rural,36119,187982,101060,86922
9,181,DISTRICT,Shrawasti,Urban,242,1352,725,627
9,182,DISTRICT,Balrampur,Total,47946,277212,145928,131284
9,182,DISTRICT,Balrampur,Rural,46436,268612,141426,127186
9,182,DISTRICT,Balrampur,Urban,1510,8600,4502,4098
9,183,DISTRICT,Gonda,Total,91206,531973,276656,255317
9,183,DISTRICT,Gonda,Rural,88295,515769,268210,247559
9,183,DISTRICT,Gonda,Urban,2911,16204,8446,7758
9,184,DISTRICT,Siddharthnagar,Total,68364,408763,208990,199773
9,184,DISTRICT,Siddharthnagar,Rural,65644,392650,200566,192084
9,184,DISTRICT,Siddharthnagar,Urban,2720,16113,8424,7689
9,185,DISTRICT,Basti,Total,88352,513959,262534,251425
9,185,DISTRICT,Basti,Rural,85030,493904,252024,241880
9,185,DISTRICT,Basti,Urban,3322,20055,10510,9545
9,186,DISTRICT,Sant Kabir Nagar,Total,60293,369039,187413,181626
9,186,DISTRICT,Sant Kabir Nagar,Rural,57720,353460,179233,174227
9,186,DISTRICT,Sant Kabir Nagar,Urban,2573,15579,8180,7399
9,187,DISTRICT,Mahrajganj,Total,86697,492976,254426,238550
9,187,DISTRICT,Mahrajganj,Rural,83673,475865,245639,230226
9,187,DISTRICT,Mahrajganj,Urban,3024,17111,8787,8324
9,188,DISTRICT,Gorakhpur,Total,159847,936061,481123,454938
9,188,DISTRICT,Gorakhpur,Rural,144270,849249,435137,414112
9,188,DISTRICT,Gorakhpur,Urban,15577,86812,45986,40826
9,189,DISTRICT,Kushinagar,Total,93475,544231,278947,265284
9,189,DISTRICT,Kushinagar,Rural,91526,533210,273250,259960
9,189,DISTRICT,Kushinagar,Urban,1949,11021,5697,5324
9,190,DISTRICT,Deoria,Total,76763,468663,235694,232969
9,190,DISTRICT,Deoria,Rural,72234,440954,221038,219916
9,190,DISTRICT,Deoria,Urban,4529,27709,14656,13053
9,191,DISTRICT,Azamgarh,Total,184963,1171378,579586,591792
9,191,DISTRICT,Azamgarh,Rural,177749,1123453,554540,568913
9,191,DISTRICT,Azamgarh,Urban,7214,47925,25046,22879
9,192,DISTRICT,Mau,Total,77178,474537,241498,233039
9,192,DISTRICT,Mau,Rural,69118,422657,214423,208234
9,192,DISTRICT,Mau,Urban,8060,51880,27075,24805
9,193,DISTRICT,Ballia,Total,78010,494698,257624,237074
9,193,DISTRICT,Ballia,Rural,73805,466723,242906,223817
9,193,DISTRICT,Ballia,Urban,4205,27975,14718,13257
9,194,DISTRICT,Jaunpur,Total,161032,990345,494226,496119
9,194,DISTRICT,Jaunpur,Rural,156306,959704,478315,481389
9,194,DISTRICT,Jaunpur,Urban,4726,30641,15911,14730
9,195,DISTRICT,Ghazipur,Total,120747,726641,375015,351626
9,195,DISTRICT,Ghazipur,Rural,116508,700013,361051,338962
9,195,DISTRICT,Ghazipur,Urban,4239,26628,13964,12664
9,196,DISTRICT,Chandauli,Total,75680,446786,235161,211625
9,196,DISTRICT,Chandauli,Rural,70120,412719,217180,195539
9,196,DISTRICT,Chandauli,Urban,5560,34067,17981,16086
9,197,DISTRICT,Varanasi,Total,82714,486958,256483,230475
9,197,DISTRICT,Varanasi,Rural,61301,358612,187942,170670
9,197,DISTRICT,Varanasi,Urban,21413,128346,68541,59805
9,198,DISTRICT,Sant Ravidas Nagar (Bhadohi),Total,55180,353103,182617,170486
9,198,DISTRICT,Sant Ravidas Nagar (Bhadohi),Rural,50460,322782,166710,156072
9,198,DISTRICT,Sant Ravidas Nagar (Bhadohi),Urban,4720,30321,15907,14414
9,199,DISTRICT,Mirzapur,Total,113235,661129,347436,313693
9,199,DISTRICT,Mirzapur,Rural,105497,613590,321829,291761
9,199,DISTRICT,Mirzapur,Urban,7738,47539,25607,21932
9,200,DISTRICT,Sonbhadra,Total,77570,421661,218996,202665
9,200,DISTRICT,Sonbhadra,Rural,70420,384816,199415,185401
9,200,DISTRICT,Sonbhadra,Urban,7150,36845,19581,17264
9,201,DISTRICT,Etah,Total,47129,281011,150631,130380
9,201,DISTRICT,Etah,Rural,41267,245671,131760,113911
9,201,DISTRICT,Etah,Urban,5862,35340,18871,16469
9,202,DISTRICT,Kanshiram Nagar,Total,43134,254299,135812,118487
9,202,DISTRICT,Kanshiram Nagar,Rural,37964,222875,119043,103832
9,202,DISTRICT,Kanshiram Nagar,Urban,5170,31424,16769,14655
10,0,State,BIHAR,Total,3073109,16567325,8606253,7961072
10,0,State,BIHAR,Rural,2857195,15344215,7964360,7379855
10,0,State,BIHAR,Urban,215914,1223110,641893,581217
10,203,DISTRICT,Pashchim Champaran,Total,106228,553944,289191,264753
10,203,DISTRICT,Pashchim Champaran,Rural,100573,524727,273843,250884
10,203,DISTRICT,Pashchim Champaran,Urban,5655,29217,15348,13869
10,204,DISTRICT,Purba Champaran,Total,129393,649726,340363,309363
10,204,DISTRICT,Purba Champaran,Rural,122535,612980,320861,292119
10,204,DISTRICT,Purba Champaran,Urban,6858,36746,19502,17244
10,205,DISTRICT,Sheohar,Total,21804,96655,51089,45566
10,205,DISTRICT,Sheohar,Rural,21007,92917,49131,43786
10,205,DISTRICT,Sheohar,Urban,797,3738,1958,1780
10,206,DISTRICT,Sitamarhi,Total,87859,405714,213624,192090
10,206,DISTRICT,Sitamarhi,Rural,84295,388240,204336,183904
10,206,DISTRICT,Sitamarhi,Urban,3564,17474,9288,8186
10,207,DISTRICT,Madhubani,Total,119692,587158,303389,283769
10,207,DISTRICT,Madhubani,Rural,116896,572195,295686,276509
10,207,DISTRICT,Madhubani,Urban,2796,14963,7703,7260
10,208,DISTRICT,Supaul,Total,69177,354249,182545,171704
10,208,DISTRICT,Supaul,Rural,67072,343484,176922,166562
10,208,DISTRICT,Supaul,Urban,2105,10765,5623,5142
10,209,DISTRICT,Araria,Total,78408,382654,198247,184407
10,209,DISTRICT,Araria,Rural,75055,366088,189565,176523
10,209,DISTRICT,Araria,Urban,3353,16566,8682,7884
10,210,DISTRICT,Kishanganj,Total,24357,113118,57964,55154
10,210,DISTRICT,Kishanganj,Rural,20772,95770,49079,46691
10,210,DISTRICT,Kishanganj,Urban,3585,17348,8885,8463
10,211,DISTRICT,Purnia,Total,78793,390991,203201,187790
10,211,DISTRICT,Purnia,Rural,72488,358546,186428,172118
10,211,DISTRICT,Purnia,Urban,6305,32445,16773,15672
10,212,DISTRICT,Katihar,Total,55035,263100,136429,126671
10,212,DISTRICT,Katihar,Rural,48796,231323,119738,111585
10,212,DISTRICT,Katihar,Urban,6239,31777,16691,15086
10,213,DISTRICT,Madhepura,Total,68837,346275,179337,166938
10,213,DISTRICT,Madhepura,Rural,66927,336576,174330,162246
10,213,DISTRICT,Madhepura,Urban,1910,9699,5007,4692
10,214,DISTRICT,Saharsa,Total,61454,317249,164518,152731
10,214,DISTRICT,Saharsa,Rural,59153,304657,157925,146732
10,214,DISTRICT,Saharsa,Urban,2301,12592,6593,5999
10,215,DISTRICT,Darbhanga,Total,123669,615688,322327,293361
10,215,DISTRICT,Darbhanga,Rural,115021,570735,298657,272078
10,215,DISTRICT,Darbhanga,Urban,8648,44953,23670,21283
10,216,DISTRICT,Muzaffarpur,Total,149497,751975,393135,358840
10,216,DISTRICT,Muzaffarpur,Rural,141249,708488,370147,338341
10,216,DISTRICT,Muzaffarpur,Urban,8248,43487,22988,20499
10,217,DISTRICT,Gopalganj,Total,54467,320064,159265,160799
10,217,DISTRICT,Gopalganj,Rural,51853,304316,151273,153043
10,217,DISTRICT,Gopalganj,Urban,2614,15748,7992,7756
10,218,DISTRICT,Siwan,Total,64979,386685,195965,190720
10,218,DISTRICT,Siwan,Rural,63135,375375,190048,185327
10,218,DISTRICT,Siwan,Urban,1844,11310,5917,5393
10,219,DISTRICT,Saran,Total,78943,474066,242976,231090
10,219,DISTRICT,Saran,Rural,73184,438183,224216,213967
10,219,DISTRICT,Saran,Urban,5759,35883,18760,17123
10,220,DISTRICT,Vaishali,Total,135156,738031,387827,350204
10,220,DISTRICT,Vaishali,Rural,128394,697630,366471,331159
10,220,DISTRICT,Vaishali,Urban,6762,40401,21356,19045
10,221,DISTRICT,Samastipur,Total,160002,803128,417944,385184
10,221,DISTRICT,Samastipur,Rural,155607,779343,405637,373706
10,221,DISTRICT,Samastipur,Urban,4395,23785,12307,11478
10,222,DISTRICT,Begusarai,Total,86800,432270,227481,204789
10,222,DISTRICT,Begusarai,Rural,75331,371169,195063,176106
10,222,DISTRICT,Begusarai,Urban,11469,61101,32418,28683
10,223,DISTRICT,Khagaria,Total,49213,247161,130191,116970
10,223,DISTRICT,Khagaria,Rural,47980,240583,126665,113918
10,223,DISTRICT,Khagaria,Urban,1233,6578,3526,3052
10,224,DISTRICT,Bhagalpur,Total,60287,318569,169667,148902
10,224,DISTRICT,Bhagalpur,Rural,51359,269088,143340,125748
10,224,DISTRICT,Bhagalpur,Urban,8928,49481,26327,23154
10,225,DISTRICT,Banka,Total,48472,247858,129663,118195
10,225,DISTRICT,Banka,Rural,47010,240233,125621,114612
10,225,DISTRICT,Banka,Urban,1462,7625,4042,3583
10,226,DISTRICT,Munger,Total,36318,183846,97195,86651
10,226,DISTRICT,Munger,Rural,29720,148713,78652,70061
10,226,DISTRICT,Munger,Urban,6598,35133,18543,16590
10,227,DISTRICT,Lakhisarai,Total,26800,153209,80069,73140
10,227,DISTRICT,Lakhisarai,Rural,24231,138294,72261,66033
10,227,DISTRICT,Lakhisarai,Urban,2569,14915,7808,7107
10,228,DISTRICT,Sheikhpura,Total,21822,131115,67582,63533
10,228,DISTRICT,Sheikhpura,Rural,18881,113243,58305,54938
10,228,DISTRICT,Sheikhpura,Urban,2941,17872,9277,8595
10,229,DISTRICT,Nalanda,Total,104740,607672,315240,292432
10,229,DISTRICT,Nalanda,Rural,95746,555144,288063,267081
10,229,DISTRICT,Nalanda,Urban,8994,52528,27177,25351
10,230,DISTRICT,Patna,Total,161205,920918,482088,438830
10,230,DISTRICT,Patna,Rural,118098,664269,346536,317733
10,230,DISTRICT,Patna,Urban,43107,256649,135552,121097
10,231,DISTRICT,Bhojpur,Total,73329,425402,222716,202686
10,231,DISTRICT,Bhojpur,Rural,67253,387691,202966,184725
10,231,DISTRICT,Bhojpur,Urban,6076,37711,19750,17961
10,232,DISTRICT,Buxar,Total,41968,251737,131821,119916
10,232,DISTRICT,Buxar,Rural,39616,237430,124249,113181
10,232,DISTRICT,Buxar,Urban,2352,14307,7572,6735
10,233,DISTRICT,Kaimur (Bhabua),Total,61422,369088,192686,176402
10,233,DISTRICT,Kaimur (Bhabua),Rural,60111,361112,188443,172669
10,233,DISTRICT,Kaimur (Bhabua),Urban,1311,7976,4243,3733
10,234,DISTRICT,Rohtas,Total,91680,549546,286596,262950
10,234,DISTRICT,Rohtas,Rural,84839,509105,265406,243699
10,234,DISTRICT,Rohtas,Urban,6841,40441,21190,19251
10,235,DISTRICT,Aurangabad,Total,100534,612064,316161,295903
10,235,DISTRICT,Aurangabad,Rural,95955,583289,301151,282138
10,235,DISTRICT,Aurangabad,Urban,4579,28775,15010,13765
10,236,DISTRICT,Gaya,Total,225866,1334351,683943,650408
10,236,DISTRICT,Gaya,Rural,214645,1264597,647664,616933
10,236,DISTRICT,Gaya,Urban,11221,69754,36279,33475
10,237,DISTRICT,Nawada,Total,91829,565112,290050,275062
10,237,DISTRICT,Nawada,Rural,87698,540032,277051,262981
10,237,DISTRICT,Nawada,Urban,4131,25080,12999,12081
10,238,DISTRICT,Jamui,Total,58607,302649,155849,146800
10,238,DISTRICT,Jamui,Rural,55136,283426,145848,137578
10,238,DISTRICT,Jamui,Urban,3471,19223,10001,9222
10,239,DISTRICT,Jehanabad ,Total,39161,222974,115034,107940
10,239,DISTRICT,Jehanabad ,Rural,35910,203509,104847,98662
10,239,DISTRICT,Jehanabad ,Urban,3251,19465,10187,9278
10,240,DISTRICT,Arwal,Total,25306,141314,72885,68429
10,240,DISTRICT,Arwal,Rural,23664,131715,67936,63779
10,240,DISTRICT,Arwal,Urban,1642,9599,4949,4650
11,0,State,SIKKIM,Total,5930,28275,14454,13821
11,0,State,SIKKIM,Rural,4114,20335,10496,9839
11,0,State,SIKKIM,Urban,1816,7940,3958,3982
11,241,DISTRICT,North  District,Total,214,982,536,446
11,241,DISTRICT,North  District,Rural,176,804,441,363
11,241,DISTRICT,North  District,Urban,38,178,95,83
11,242,DISTRICT,West District,Total,1163,5935,3117,2818
11,242,DISTRICT,West District,Rural,1104,5663,2978,2685
11,242,DISTRICT,West District,Urban,59,272,139,133
11,243,DISTRICT,South District,Total,1254,6053,3058,2995
11,243,DISTRICT,South District,Rural,1029,5042,2569,2473
11,243,DISTRICT,South District,Urban,225,1011,489,522
11,244,DISTRICT,East District,Total,3299,15305,7743,7562
11,244,DISTRICT,East District,Rural,1805,8826,4508,4318
11,244,DISTRICT,East District,Urban,1494,6479,3235,3244
14,0,State,MANIPUR,Total,20349,97328,48863,48465
14,0,State,MANIPUR,Rural,9633,47849,24275,23574
14,0,State,MANIPUR,Urban,10716,49479,24588,24891
14,272,DISTRICT,Senapati,Total,166,1000,536,464
14,272,DISTRICT,Senapati,Rural,165,997,535,462
14,272,DISTRICT,Senapati,Urban,1,3,1,2
14,273,DISTRICT,Tamenglong ,Total,4,22,17,5
14,273,DISTRICT,Tamenglong ,Rural,3,18,15,3
14,273,DISTRICT,Tamenglong ,Urban,1,4,2,2
14,274,DISTRICT,Churachandpur,Total,81,443,244,199
14,274,DISTRICT,Churachandpur,Rural,73,424,230,194
14,274,DISTRICT,Churachandpur,Urban,8,19,14,5
14,275,DISTRICT,Bishnupur,Total,4120,22113,11085,11028
14,275,DISTRICT,Bishnupur,Rural,4068,21834,10949,10885
14,275,DISTRICT,Bishnupur,Urban,52,279,136,143
14,276,DISTRICT,Thoubal,Total,9032,40593,20137,20456
14,276,DISTRICT,Thoubal,Rural,996,4397,2217,2180
14,276,DISTRICT,Thoubal,Urban,8036,36196,17920,18276
14,277,DISTRICT,Imphal West,Total,3727,16530,8308,8222
14,277,DISTRICT,Imphal West,Rural,2722,11711,5846,5865
14,277,DISTRICT,Imphal West,Urban,1005,4819,2462,2357
14,278,DISTRICT,Imphal East,Total,3074,15839,8055,7784
14,278,DISTRICT,Imphal East,Rural,1490,7815,4081,3734
14,278,DISTRICT,Imphal East,Urban,1584,8024,3974,4050
14,279,DISTRICT,Ukhrul,Total,42,248,160,88
14,279,DISTRICT,Ukhrul,Rural,23,154,100,54
14,279,DISTRICT,Ukhrul,Urban,19,94,60,34
14,280,DISTRICT,Chandel,Total,103,540,321,219
14,280,DISTRICT,Chandel,Rural,93,499,302,197
14,280,DISTRICT,Chandel,Urban,10,41,19,22
15,0,State,MIZORAM,Total,274,1218,807,411
15,0,State,MIZORAM,Rural,60,298,209,89
15,0,State,MIZORAM,Urban,214,920,598,322
15,281,DISTRICT,Mamit,Total,18,51,42,9
15,281,DISTRICT,Mamit,Rural,14,38,31,7
15,281,DISTRICT,Mamit,Urban,4,13,11,2
15,282,DISTRICT,Kolasib,Total,22,84,59,25
15,282,DISTRICT,Kolasib,Rural,5,17,12,5
15,282,DISTRICT,Kolasib,Urban,17,67,47,20
15,283,DISTRICT,Aizawl,Total,147,627,388,239
15,283,DISTRICT,Aizawl,Rural,7,46,36,10
15,283,DISTRICT,Aizawl,Urban,140,581,352,229
15,284,DISTRICT,Champhai,Total,5,17,16,1
15,284,DISTRICT,Champhai,Rural,3,10,9,1
15,284,DISTRICT,Champhai,Urban,2,7,7,0
15,285,DISTRICT,Serchhip,Total,10,32,20,12
15,285,DISTRICT,Serchhip,Rural,5,13,8,5
15,285,DISTRICT,Serchhip,Urban,5,19,12,7
15,286,DISTRICT,Lunglei,Total,32,178,125,53
15,286,DISTRICT,Lunglei,Rural,9,65,38,27
15,286,DISTRICT,Lunglei,Urban,23,113,87,26
15,287,DISTRICT,Lawngtlai,Total,22,146,105,41
15,287,DISTRICT,Lawngtlai,Rural,15,97,68,29
15,287,DISTRICT,Lawngtlai,Urban,7,49,37,12
15,288,DISTRICT,Saiha,Total,18,83,52,31
15,288,DISTRICT,Saiha,Rural,2,12,7,5
15,288,DISTRICT,Saiha,Urban,16,71,45,26
16,0,State,TRIPURA,Total,154112,654918,334370,320548
16,0,State,TRIPURA,Rural,102140,437993,224498,213495
16,0,State,TRIPURA,Urban,51972,216925,109872,107053
16,289,DISTRICT,West Tripura ,Total,79826,338094,172522,165572
16,289,DISTRICT,West Tripura ,Rural,43813,186463,95784,90679
16,289,DISTRICT,West Tripura ,Urban,36013,151631,76738,74893
16,290,DISTRICT,South Tripura ,Total,34402,140168,72012,68156
16,290,DISTRICT,South Tripura ,Rural,27047,111464,57336,54128
16,290,DISTRICT,South Tripura ,Urban,7355,28704,14676,14028
16,291,DISTRICT,Dhalai,Total,14393,61688,31461,30227
16,291,DISTRICT,Dhalai,Rural,11635,50539,25853,24686
16,291,DISTRICT,Dhalai,Urban,2758,11149,5608,5541
16,292,DISTRICT,North Tripura,Total,25491,114968,58375,56593
16,292,DISTRICT,North Tripura,Rural,19645,89527,45525,44002
16,292,DISTRICT,North Tripura,Urban,5846,25441,12850,12591
17,0,State,MEGHALAYA,Total,3533,17355,9157,8198
17,0,State,MEGHALAYA,Rural,2357,11573,6086,5487
17,0,State,MEGHALAYA,Urban,1176,5782,3071,2711
17,293,DISTRICT,West Garo Hills,Total,1826,8810,4535,4275
17,293,DISTRICT,West Garo Hills,Rural,1313,6249,3197,3052
17,293,DISTRICT,West Garo Hills,Urban,513,2561,1338,1223
17,294,DISTRICT,East Garo Hills,Total,102,509,304,205
17,294,DISTRICT,East Garo Hills,Rural,40,215,128,87
17,294,DISTRICT,East Garo Hills,Urban,62,294,176,118
17,295,DISTRICT,South Garo Hills,Total,73,319,188,131
17,295,DISTRICT,South Garo Hills,Rural,47,191,109,82
17,295,DISTRICT,South Garo Hills,Urban,26,128,79,49
17,296,DISTRICT,West Khasi Hills,Total,43,168,93,75
17,296,DISTRICT,West Khasi Hills,Rural,38,145,83,62
17,296,DISTRICT,West Khasi Hills,Urban,5,23,10,13
17,297,DISTRICT,Ribhoi,Total,120,590,329,261
17,297,DISTRICT,Ribhoi,Rural,100,504,279,225
17,297,DISTRICT,Ribhoi,Urban,20,86,50,36
17,298,DISTRICT,East Khasi Hills,Total,1082,5642,2924,2718
17,298,DISTRICT,East Khasi Hills,Rural,560,3054,1566,1488
17,298,DISTRICT,East Khasi Hills,Urban,522,2588,1358,1230
17,299,DISTRICT,Jaintia Hills,Total,287,1317,784,533
17,299,DISTRICT,Jaintia Hills,Rural,259,1215,724,491
17,299,DISTRICT,Jaintia Hills,Urban,28,102,60,42
18,0,State,ASSAM,Total,468568,2231321,1145314,1086007
18,0,State,ASSAM,Rural,380579,1825761,938664,887097
18,0,State,ASSAM,Urban,87989,405560,206650,198910
18,300,DISTRICT,Kokrajhar,Total,6163,29570,15386,14184
18,300,DISTRICT,Kokrajhar,Rural,4954,23747,12381,11366
18,300,DISTRICT,Kokrajhar,Urban,1209,5823,3005,2818
18,301,DISTRICT,Dhubri,Total,15860,70395,36359,34036
18,301,DISTRICT,Dhubri,Rural,9420,39929,20692,19237
18,301,DISTRICT,Dhubri,Urban,6440,30466,15667,14799
18,302,DISTRICT,Goalpara,Total,9562,45094,22999,22095
18,302,DISTRICT,Goalpara,Rural,6976,32886,16833,16053
18,302,DISTRICT,Goalpara,Urban,2586,12208,6166,6042
18,303,DISTRICT,Barpeta,Total,19545,95320,49165,46155
18,303,DISTRICT,Barpeta,Rural,15265,73946,38163,35783
18,303,DISTRICT,Barpeta,Urban,4280,21374,11002,10372
18,304,DISTRICT,Morigaon,Total,22857,117841,60194,57647
18,304,DISTRICT,Morigaon,Rural,20970,109307,55874,53433
18,304,DISTRICT,Morigaon,Urban,1887,8534,4320,4214
18,305,DISTRICT,Nagaon,Total,55376,266350,136473,129877
18,305,DISTRICT,Nagaon,Rural,47305,228530,117173,111357
18,305,DISTRICT,Nagaon,Urban,8071,37820,19300,18520
18,306,DISTRICT,Sonitpur,Total,23106,109130,55817,53313
18,306,DISTRICT,Sonitpur,Rural,19850,94692,48464,46228
18,306,DISTRICT,Sonitpur,Urban,3256,14438,7353,7085
18,307,DISTRICT,Lakhimpur,Total,16765,81840,41689,40151
18,307,DISTRICT,Lakhimpur,Rural,15157,74891,38107,36784
18,307,DISTRICT,Lakhimpur,Urban,1608,6949,3582,3367
18,308,DISTRICT,Dhemaji,Total,8386,44225,23006,21219
18,308,DISTRICT,Dhemaji,Rural,7660,40524,21061,19463
18,308,DISTRICT,Dhemaji,Urban,726,3701,1945,1756
18,309,DISTRICT,Tinsukia,Total,7624,37688,19443,18245
18,309,DISTRICT,Tinsukia,Rural,4964,25286,13057,12229
18,309,DISTRICT,Tinsukia,Urban,2660,12402,6386,6016
18,310,DISTRICT,Dibrugarh,Total,11971,58876,30517,28359
18,310,DISTRICT,Dibrugarh,Rural,8314,41396,21480,19916
18,310,DISTRICT,Dibrugarh,Urban,3657,17480,9037,8443
18,311,DISTRICT,Sivasagar,Total,9050,42347,21568,20779
18,311,DISTRICT,Sivasagar,Rural,7238,34483,17526,16957
18,311,DISTRICT,Sivasagar,Urban,1812,7864,4042,3822
18,312,DISTRICT,Jorhat,Total,19122,88665,45194,43471
18,312,DISTRICT,Jorhat,Rural,15438,72434,36973,35461
18,312,DISTRICT,Jorhat,Urban,3684,16231,8221,8010
18,313,DISTRICT,Golaghat,Total,13488,62298,31807,30491
18,313,DISTRICT,Golaghat,Rural,12102,56152,28636,27516
18,313,DISTRICT,Golaghat,Urban,1386,6146,3171,2975
18,314,DISTRICT,Karbi Anglong,Total,8290,44961,23436,21525
18,314,DISTRICT,Karbi Anglong,Rural,7222,39936,20798,19138
18,314,DISTRICT,Karbi Anglong,Urban,1068,5025,2638,2387
18,315,DISTRICT,Dima Hasao,Total,900,4337,2340,1997
18,315,DISTRICT,Dima Hasao,Rural,357,1885,1070,815
18,315,DISTRICT,Dima Hasao,Urban,543,2452,1270,1182
18,316,DISTRICT,Cachar,Total,58636,264897,136051,128846
18,316,DISTRICT,Cachar,Rural,48318,216090,111487,104603
18,316,DISTRICT,Cachar,Urban,10318,48807,24564,24243
18,317,DISTRICT,Karimganj,Total,33101,157890,81384,76506
18,317,DISTRICT,Karimganj,Rural,30211,144169,74557,69612
18,317,DISTRICT,Karimganj,Urban,2890,13721,6827,6894
18,318,DISTRICT,Hailakandi,Total,16160,70659,36369,34290
18,318,DISTRICT,Hailakandi,Rural,15149,65736,33919,31817
18,318,DISTRICT,Hailakandi,Urban,1011,4923,2450,2473
18,319,DISTRICT,Bongaigaon,Total,17240,82784,42513,40271
18,319,DISTRICT,Bongaigaon,Rural,13795,67460,34760,32700
18,319,DISTRICT,Bongaigaon,Urban,3445,15324,7753,7571
18,320,DISTRICT,Chirang,Total,7186,35135,18105,17030
18,320,DISTRICT,Chirang,Rural,6387,31362,16212,15150
18,320,DISTRICT,Chirang,Urban,799,3773,1893,1880
18,321,DISTRICT,Kamrup,Total,22180,107827,55237,52590
18,321,DISTRICT,Kamrup,Rural,18089,88975,45829,43146
18,321,DISTRICT,Kamrup,Urban,4091,18852,9408,9444
18,322,DISTRICT,Kamrup Metropolitan,Total,22386,101789,52106,49683
18,322,DISTRICT,Kamrup Metropolitan,Rural,6673,33499,17181,16318
18,322,DISTRICT,Kamrup Metropolitan,Urban,15713,68290,34925,33365
18,323,DISTRICT,Nalbari,Total,12674,60216,30654,29562
18,323,DISTRICT,Nalbari,Rural,11396,54232,27675,26557
18,323,DISTRICT,Nalbari,Urban,1278,5984,2979,3005
18,324,DISTRICT,Baksa,Total,14856,73083,37534,35549
18,324,DISTRICT,Baksa,Rural,14521,71382,36641,34741
18,324,DISTRICT,Baksa,Urban,335,1701,893,808
18,325,DISTRICT,Darrang,Total,8494,40260,20566,19694
18,325,DISTRICT,Darrang,Rural,6029,28746,14636,14110
18,325,DISTRICT,Darrang,Urban,2465,11514,5930,5584
18,326,DISTRICT,Udalguri,Total,7590,37844,19402,18442
18,326,DISTRICT,Udalguri,Rural,6819,34086,17479,16607
18,326,DISTRICT,Udalguri,Urban,771,3758,1923,1835
19,0,State,WEST BENGAL,Total,4861303,21463270,11003304,10459966
19,0,State,WEST BENGAL,Rural,3877380,17095107,8764294,8330813
19,0,State,WEST BENGAL,Urban,983923,4368163,2239010,2129153
19,327,DISTRICT,Darjiling ,Total,68028,317275,161495,155780
19,327,DISTRICT,Darjiling ,Rural,48159,224822,114866,109956
19,327,DISTRICT,Darjiling ,Urban,19869,92453,46629,45824
19,328,DISTRICT,Jalpaiguri ,Total,331711,1458278,750841,707437
19,328,DISTRICT,Jalpaiguri ,Rural,263819,1159391,597567,561824
19,328,DISTRICT,Jalpaiguri ,Urban,67892,298887,153274,145613
19,329,DISTRICT,Koch Bihar ,Total,337085,1414336,728506,685830
19,329,DISTRICT,Koch Bihar ,Rural,321718,1350657,696254,654403
19,329,DISTRICT,Koch Bihar ,Urban,15367,63679,32252,31427
19,330,DISTRICT,Uttar Dinajpur,Total,173687,807950,418288,389662
19,330,DISTRICT,Uttar Dinajpur,Rural,160161,741154,383329,357825
19,330,DISTRICT,Uttar Dinajpur,Urban,13526,66796,34959,31837
19,331,DISTRICT,Dakshin Dinajpur,Total,113649,482754,248312,234442
19,331,DISTRICT,Dakshin Dinajpur,Rural,103947,440182,226420,213762
19,331,DISTRICT,Dakshin Dinajpur,Urban,9702,42572,21892,20680
19,332,DISTRICT,Maldah ,Total,183844,835430,432744,402686
19,332,DISTRICT,Maldah ,Rural,169344,767492,396637,370855
19,332,DISTRICT,Maldah ,Urban,14500,67938,36107,31831
19,333,DISTRICT,Murshidabad ,Total,203435,897534,460143,437391
19,333,DISTRICT,Murshidabad ,Rural,166328,727721,373388,354333
19,333,DISTRICT,Murshidabad ,Urban,37107,169813,86755,83058
19,334,DISTRICT,Birbhum,Total,243268,1033140,529001,504139
19,334,DISTRICT,Birbhum,Rural,221081,934054,478901,455153
19,334,DISTRICT,Birbhum,Urban,22187,99086,50100,48986
19,335,DISTRICT,Barddhaman ,Total,477661,2115719,1079584,1036135
19,335,DISTRICT,Barddhaman ,Rural,355179,1524133,776238,747895
19,335,DISTRICT,Barddhaman ,Urban,122482,591586,303346,288240
19,336,DISTRICT,Nadia ,Total,358081,1546917,798258,748659
19,336,DISTRICT,Nadia ,Rural,263529,1141341,590538,550803
19,336,DISTRICT,Nadia ,Urban,94552,405576,207720,197856
19,337,DISTRICT,North Twenty Four Parganas,Total,512145,2169084,1115458,1053626
19,337,DISTRICT,North Twenty Four Parganas,Rural,297708,1252699,646150,606549
19,337,DISTRICT,North Twenty Four Parganas,Urban,214437,916385,469308,447077
19,338,DISTRICT,Hugli ,Total,314154,1344021,680992,663029
19,338,DISTRICT,Hugli ,Rural,246898,1053739,532867,520872
19,338,DISTRICT,Hugli ,Urban,67256,290282,148125,142157
19,339,DISTRICT,Bankura ,Total,255409,1174447,593440,581007
19,339,DISTRICT,Bankura ,Rural,240816,1105653,559234,546419
19,339,DISTRICT,Bankura ,Urban,14593,68794,34206,34588
19,340,DISTRICT,Puruliya,Total,108633,567767,290789,276978
19,340,DISTRICT,Puruliya,Rural,94266,490517,251410,239107
19,340,DISTRICT,Puruliya,Urban,14367,77250,39379,37871
19,341,DISTRICT,Haora ,Total,162864,718951,367053,351898
19,341,DISTRICT,Haora ,Rural,92143,407815,207531,200284
19,341,DISTRICT,Haora ,Urban,70721,311136,159522,151614
19,342,DISTRICT,Kolkata,Total,54982,241932,128053,113879
19,342,DISTRICT,Kolkata,Rural,0,0,0,0
19,342,DISTRICT,Kolkata,Urban,54982,241932,128053,113879
19,343,DISTRICT,South Twenty Four Parganas,Total,555020,2464032,1266504,1197528
19,343,DISTRICT,South Twenty Four Parganas,Rural,459068,2062297,1061324,1000973
19,343,DISTRICT,South Twenty Four Parganas,Urban,95952,401735,205180,196555
19,344,DISTRICT,Paschim Medinipur,Total,246625,1128269,570125,558144
19,344,DISTRICT,Paschim Medinipur,Rural,226630,1034177,523162,511015
19,344,DISTRICT,Paschim Medinipur,Urban,19995,94092,46963,47129
19,345,DISTRICT,Purba Medinipur,Total,161022,745434,383718,361716
19,345,DISTRICT,Purba Medinipur,Rural,146586,677263,348478,328785
19,345,DISTRICT,Purba Medinipur,Urban,14436,68171,35240,32931
20,0,State,JHARKHAND,Total,753644,3985644,2043458,1942186
20,0,State,JHARKHAND,Rural,596688,3152863,1612513,1540350
20,0,State,JHARKHAND,Urban,156956,832781,430945,401836
20,346,DISTRICT,Garhwa ,Total,62283,319946,165313,154633
20,346,DISTRICT,Garhwa ,Rural,60115,308843,159417,149426
20,346,DISTRICT,Garhwa ,Urban,2168,11103,5896,5207
20,347,DISTRICT,Chatra,Total,61845,340553,172668,167885
20,347,DISTRICT,Chatra,Rural,60358,332431,168424,164007
20,347,DISTRICT,Chatra,Urban,1487,8122,4244,3878
20,348,DISTRICT,Kodarma,Total,18662,109003,55346,53657
20,348,DISTRICT,Kodarma,Rural,15945,93885,47509,46376
20,348,DISTRICT,Kodarma,Urban,2717,15118,7837,7281
20,349,DISTRICT,Giridih,Total,54669,325493,166447,159046
20,349,DISTRICT,Giridih,Rural,50515,301327,154039,147288
20,349,DISTRICT,Giridih,Urban,4154,24166,12408,11758
20,350,DISTRICT,Deoghar,Total,35744,190036,98295,91741
20,350,DISTRICT,Deoghar,Rural,30148,159077,82050,77027
20,350,DISTRICT,Deoghar,Urban,5596,30959,16245,14714
20,351,DISTRICT,Godda,Total,22045,115567,59835,55732
20,351,DISTRICT,Godda,Rural,21255,111055,57502,53553
20,351,DISTRICT,Godda,Urban,790,4512,2333,2179
20,352,DISTRICT,Sahibganj,Total,14699,72341,37317,35024
20,352,DISTRICT,Sahibganj,Rural,11864,57490,29560,27930
20,352,DISTRICT,Sahibganj,Urban,2835,14851,7757,7094
20,353,DISTRICT,Pakur,Total,5817,28469,14352,14117
20,353,DISTRICT,Pakur,Rural,5143,25177,12698,12479
20,353,DISTRICT,Pakur,Urban,674,3292,1654,1638
20,354,DISTRICT,Dhanbad,Total,82404,437309,226362,210947
20,354,DISTRICT,Dhanbad,Rural,30720,163090,83786,79304
20,354,DISTRICT,Dhanbad,Urban,51684,274219,142576,131643
20,355,DISTRICT,Bokaro,Total,57011,299227,154297,144930
20,355,DISTRICT,Bokaro,Rural,34107,175690,90291,85399
20,355,DISTRICT,Bokaro,Urban,22904,123537,64006,59531
20,356,DISTRICT,Lohardaga,Total,3183,15330,7862,7468
20,356,DISTRICT,Lohardaga,Rural,2698,13035,6680,6355
20,356,DISTRICT,Lohardaga,Urban,485,2295,1182,1113
20,357,DISTRICT,Purbi Singhbhum,Total,22994,111414,56147,55267
20,357,DISTRICT,Purbi Singhbhum,Rural,9880,44771,22363,22408
20,357,DISTRICT,Purbi Singhbhum,Urban,13114,66643,33784,32859
20,358,DISTRICT,Palamu,Total,101071,536382,277119,259263
20,358,DISTRICT,Palamu,Rural,95045,503315,259749,243566
20,358,DISTRICT,Palamu,Urban,6026,33067,17370,15697
20,359,DISTRICT,Latehar,Total,28733,154910,78266,76644
20,359,DISTRICT,Latehar,Rural,27016,146213,73813,72400
20,359,DISTRICT,Latehar,Urban,1717,8697,4453,4244
20,360,DISTRICT,Hazaribagh,Total,55406,303515,155013,148502
20,360,DISTRICT,Hazaribagh,Rural,49831,272868,139157,133711
20,360,DISTRICT,Hazaribagh,Urban,5575,30647,15856,14791
20,361,DISTRICT,Ramgarh,Total,20206,106356,54986,51370
20,361,DISTRICT,Ramgarh,Rural,9625,50227,25853,24374
20,361,DISTRICT,Ramgarh,Urban,10581,56129,29133,26996
20,362,DISTRICT,Dumka,Total,16406,79614,40802,38812
20,362,DISTRICT,Dumka,Rural,14888,71695,36714,34981
20,362,DISTRICT,Dumka,Urban,1518,7919,4088,3831
20,363,DISTRICT,Jamtara,Total,14849,72885,37212,35673
20,363,DISTRICT,Jamtara,Rural,12969,63026,32105,30921
20,363,DISTRICT,Jamtara,Urban,1880,9859,5107,4752
20,364,DISTRICT,Ranchi,Total,30702,152943,78613,74330
20,364,DISTRICT,Ranchi,Rural,17629,84270,43088,41182
20,364,DISTRICT,Ranchi,Urban,13073,68673,35525,33148
20,365,DISTRICT,Khunti,Total,5007,24037,12223,11814
20,365,DISTRICT,Khunti,Rural,4408,21223,10799,10424
20,365,DISTRICT,Khunti,Urban,599,2814,1424,1390
20,366,DISTRICT,Gumla,Total,6599,32459,16446,16013
20,366,DISTRICT,Gumla,Rural,6024,29506,14880,14626
20,366,DISTRICT,Gumla,Urban,575,2953,1566,1387
20,367,DISTRICT,Simdega,Total,9364,44674,22150,22524
20,367,DISTRICT,Simdega,Rural,8984,42751,21196,21555
20,367,DISTRICT,Simdega,Urban,380,1923,954,969
20,368,DISTRICT,Pashchimi Singhbhum,Total,12147,56986,28144,28842
20,368,DISTRICT,Pashchimi Singhbhum,Rural,8306,38215,18916,19299
20,368,DISTRICT,Pashchimi Singhbhum,Urban,3841,18771,9228,9543
20,369,DISTRICT,Saraikela-Kharsawan,Total,11798,56195,28243,27952
20,369,DISTRICT,Saraikela-Kharsawan,Rural,9215,43683,21924,21759
20,369,DISTRICT,Saraikela-Kharsawan,Urban,2583,12512,6319,6193
21,0,State,ODISHA,Total,1669787,7188463,3617808,3570655
21,0,State,ODISHA,Rural,1457972,6218642,3127719,3090923
21,0,State,ODISHA,Urban,211815,969821,490089,479732
21,370,DISTRICT,Bargarh,Total,76327,298780,150420,148360
21,370,DISTRICT,Bargarh,Rural,69632,269396,135660,133736
21,370,DISTRICT,Bargarh,Urban,6695,29384,14760,14624
21,371,DISTRICT,Jharsuguda,Total,25543,104620,52580,52040
21,371,DISTRICT,Jharsuguda,Rural,17385,68740,34397,34343
21,371,DISTRICT,Jharsuguda,Urban,8158,35880,18183,17697
21,372,DISTRICT,Sambalpur,Total,47321,191827,96511,95316
21,372,DISTRICT,Sambalpur,Rural,34446,134729,67886,66843
21,372,DISTRICT,Sambalpur,Urban,12875,57098,28625,28473
21,373,DISTRICT,Debagarh,Total,12998,52112,26343,25769
21,373,DISTRICT,Debagarh,Rural,12035,48246,24428,23818
21,373,DISTRICT,Debagarh,Urban,963,3866,1915,1951
21,374,DISTRICT,Sundargarh,Total,46312,191660,96465,95195
21,374,DISTRICT,Sundargarh,Rural,29168,115853,57762,58091
21,374,DISTRICT,Sundargarh,Urban,17144,75807,38703,37104
21,375,DISTRICT,Kendujhar,Total,48642,209357,104684,104673
21,375,DISTRICT,Kendujhar,Rural,40362,172913,86283,86630
21,375,DISTRICT,Kendujhar,Urban,8280,36444,18401,18043
21,376,DISTRICT,Mayurbhanj,Total,45944,184682,92127,92555
21,376,DISTRICT,Mayurbhanj,Rural,41027,163237,81424,81813
21,376,DISTRICT,Mayurbhanj,Urban,4917,21445,10703,10742
21,377,DISTRICT,Baleshwar,Total,109159,478586,243597,234989
21,377,DISTRICT,Baleshwar,Rural,102524,447936,228038,219898
21,377,DISTRICT,Baleshwar,Urban,6635,30650,15559,15091
21,378,DISTRICT,Bhadrak,Total,69559,334896,168687,166209
21,378,DISTRICT,Bhadrak,Rural,65806,316246,159293,156953
21,378,DISTRICT,Bhadrak,Urban,3753,18650,9394,9256
21,379,DISTRICT,Kendrapara ,Total,69382,309780,155531,154249
21,379,DISTRICT,Kendrapara ,Rural,66293,293691,147353,146338
21,379,DISTRICT,Kendrapara ,Urban,3089,16089,8178,7911
21,380,DISTRICT,Jagatsinghapur ,Total,56390,248152,125184,122968
21,380,DISTRICT,Jagatsinghapur ,Rural,52682,231690,116636,115054
21,380,DISTRICT,Jagatsinghapur ,Urban,3708,16462,8548,7914
21,381,DISTRICT,Cuttack,Total,113281,498633,254456,244177
21,381,DISTRICT,Cuttack,Rural,94594,406771,207678,199093
21,381,DISTRICT,Cuttack,Urban,18687,91862,46778,45084
21,382,DISTRICT,Jajapur  ,Total,99202,433387,220553,212834
21,382,DISTRICT,Jajapur  ,Rural,95469,415652,211521,204131
21,382,DISTRICT,Jajapur  ,Urban,3733,17735,9032,8703
21,383,DISTRICT,Dhenkanal,Total,56131,234079,118755,115324
21,383,DISTRICT,Dhenkanal,Rural,51937,215178,109104,106074
21,383,DISTRICT,Dhenkanal,Urban,4194,18901,9651,9250
21,384,DISTRICT,Anugul  ,Total,56165,239552,121459,118093
21,384,DISTRICT,Anugul  ,Rural,48536,205004,103752,101252
21,384,DISTRICT,Anugul  ,Urban,7629,34548,17707,16841
21,385,DISTRICT,Nayagarh  ,Total,32781,136399,69813,66586
21,385,DISTRICT,Nayagarh  ,Rural,30547,125932,64486,61446
21,385,DISTRICT,Nayagarh  ,Urban,2234,10467,5327,5140
21,386,DISTRICT,Khordha ,Total,64792,297472,151528,145944
21,386,DISTRICT,Khordha ,Rural,40857,189428,95784,93644
21,386,DISTRICT,Khordha ,Urban,23935,108044,55744,52300
21,387,DISTRICT,Puri,Total,70785,325133,164366,160767
21,387,DISTRICT,Puri,Rural,65283,296881,150019,146862
21,387,DISTRICT,Puri,Urban,5502,28252,14347,13905
21,388,DISTRICT,Ganjam,Total,149143,688235,342111,346124
21,388,DISTRICT,Ganjam,Rural,124242,566923,281268,285655
21,388,DISTRICT,Ganjam,Urban,24901,121312,60843,60469
21,389,DISTRICT,Gajapati,Total,9418,39175,19037,20138
21,389,DISTRICT,Gajapati,Rural,7204,29535,14423,15112
21,389,DISTRICT,Gajapati,Urban,2214,9640,4614,5026
21,390,DISTRICT,Kandhamal,Total,28665,115544,56987,58557
21,390,DISTRICT,Kandhamal,Rural,25181,100569,49588,50981
21,390,DISTRICT,Kandhamal,Urban,3484,14975,7399,7576
21,391,DISTRICT,Baudh,Total,25783,104934,52497,52437
21,391,DISTRICT,Baudh,Rural,24526,99438,49693,49745
21,391,DISTRICT,Baudh,Urban,1257,5496,2804,2692
21,392,DISTRICT,Subarnapur,Total,38497,156219,79725,76494
21,392,DISTRICT,Subarnapur,Rural,35497,143381,73224,70157
21,392,DISTRICT,Subarnapur,Urban,3000,12838,6501,6337
21,393,DISTRICT,Balangir,Total,72528,294777,148356,146421
21,393,DISTRICT,Balangir,Rural,65453,263126,132340,130786
21,393,DISTRICT,Balangir,Urban,7075,31651,16016,15635
21,394,DISTRICT,Nuapada,Total,20761,82159,40742,41417
21,394,DISTRICT,Nuapada,Rural,19224,75346,37415,37931
21,394,DISTRICT,Nuapada,Urban,1537,6813,3327,3486
21,395,DISTRICT,Kalahandi,Total,71391,286580,142133,144447
21,395,DISTRICT,Kalahandi,Rural,66573,264974,131474,133500
21,395,DISTRICT,Kalahandi,Urban,4818,21606,10659,10947
21,396,DISTRICT,Rayagada  ,Total,33357,139514,68068,71446
21,396,DISTRICT,Rayagada  ,Rural,28275,116657,56888,59769
21,396,DISTRICT,Rayagada  ,Urban,5082,22857,11180,11677
21,397,DISTRICT,Nabarangapur ,Total,41074,177384,88252,89132
21,397,DISTRICT,Nabarangapur ,Rural,36552,157676,78616,79060
21,397,DISTRICT,Nabarangapur ,Urban,4522,19708,9636,10072
21,398,DISTRICT,Koraput,Total,48077,196540,96789,99751
21,398,DISTRICT,Koraput,Rural,39822,160697,79036,81661
21,398,DISTRICT,Koraput,Urban,8255,35843,17753,18090
21,399,DISTRICT,Malkangiri  ,Total,30379,138295,70052,68243
21,399,DISTRICT,Malkangiri  ,Rural,26840,122797,62250,60547
21,399,DISTRICT,Malkangiri  ,Urban,3539,15498,7802,7696
22,0,State,CHHATTISGARH,Total,749457,3274269,1641738,1632531
22,0,State,CHHATTISGARH,Rural,584382,2511949,1258559,1253390
22,0,State,CHHATTISGARH,Urban,165075,762320,383179,379141
22,400,DISTRICT,Koriya,Total,12751,54776,27682,27094
22,400,DISTRICT,Koriya,Rural,7798,31238,15675,15563
22,400,DISTRICT,Koriya,Urban,4953,23538,12007,11531
22,401,DISTRICT,Surguja,Total,27773,115652,58281,57371
22,401,DISTRICT,Surguja,Rural,25113,103230,51880,51350
22,401,DISTRICT,Surguja,Urban,2660,12422,6401,6021
22,402,DISTRICT,Jashpur ,Total,12268,48844,24317,24527
22,402,DISTRICT,Jashpur ,Rural,10666,42138,21034,21104
22,402,DISTRICT,Jashpur ,Urban,1602,6706,3283,3423
22,403,DISTRICT,Raigarh,Total,58118,224942,112111,112831
22,403,DISTRICT,Raigarh,Rural,49779,188059,93642,94417
22,403,DISTRICT,Raigarh,Urban,8339,36883,18469,18414
22,404,DISTRICT,Korba ,Total,29225,124679,63446,61233
22,404,DISTRICT,Korba ,Rural,16774,67843,34246,33597
22,404,DISTRICT,Korba ,Urban,12451,56836,29200,27636
22,405,DISTRICT,Janjgir - Champa,Total,91660,397908,199633,198275
22,405,DISTRICT,Janjgir - Champa,Rural,82809,357632,179467,178165
22,405,DISTRICT,Janjgir - Champa,Urban,8851,40276,20166,20110
22,406,DISTRICT,Bilaspur,Total,123188,552992,281221,271771
22,406,DISTRICT,Bilaspur,Rural,103443,456247,231864,224383
22,406,DISTRICT,Bilaspur,Urban,19745,96745,49357,47388
22,407,DISTRICT,Kabeerdham,Total,27607,119798,60154,59644
22,407,DISTRICT,Kabeerdham,Rural,24061,104474,52490,51984
22,407,DISTRICT,Kabeerdham,Urban,3546,15324,7664,7660
22,408,DISTRICT,Rajnandgaon,Total,35320,156623,76979,79644
22,408,DISTRICT,Rajnandgaon,Rural,26444,118079,58112,59967
22,408,DISTRICT,Rajnandgaon,Urban,8876,38544,18867,19677
22,409,DISTRICT,Durg,Total,100559,458040,229067,228973
22,409,DISTRICT,Durg,Rural,63022,284513,141912,142601
22,409,DISTRICT,Durg,Urban,37537,173527,87155,86372
22,410,DISTRICT,Raipur,Total,158427,724250,362284,361966
22,410,DISTRICT,Raipur,Rural,116415,524846,262367,262479
22,410,DISTRICT,Raipur,Urban,42012,199404,99917,99487
22,411,DISTRICT,Mahasamund,Total,35541,139581,68968,70613
22,411,DISTRICT,Mahasamund,Rural,31199,120662,59686,60976
22,411,DISTRICT,Mahasamund,Urban,4342,18919,9282,9637
22,412,DISTRICT,Dhamtari ,Total,13683,58581,28887,29694
22,412,DISTRICT,Dhamtari ,Rural,10669,45455,22495,22960
22,412,DISTRICT,Dhamtari ,Urban,3014,13126,6392,6734
22,413,DISTRICT,Uttar Bastar Kanker,Total,7618,31543,15582,15961
22,413,DISTRICT,Uttar Bastar Kanker,Rural,6277,26043,12899,13144
22,413,DISTRICT,Uttar Bastar Kanker,Urban,1341,5500,2683,2817
22,414,DISTRICT,Bastar,Total,9034,37963,18815,19148
22,414,DISTRICT,Bastar,Rural,6233,25881,12839,13042
22,414,DISTRICT,Bastar,Urban,2801,12082,5976,6106
22,415,DISTRICT,Narayanpur,Total,1096,4979,2518,2461
22,415,DISTRICT,Narayanpur,Rural,804,3803,1918,1885
22,415,DISTRICT,Narayanpur,Urban,292,1176,600,576
22,416,DISTRICT,Dakshin Bastar Dantewada,Total,3154,12996,6648,6348
22,416,DISTRICT,Dakshin Bastar Dantewada,Rural,1023,4239,2226,2013
22,416,DISTRICT,Dakshin Bastar Dantewada,Urban,2131,8757,4422,4335
22,417,DISTRICT,Bijapur,Total,2435,10122,5145,4977
22,417,DISTRICT,Bijapur,Rural,1853,7567,3807,3760
22,417,DISTRICT,Bijapur,Urban,582,2555,1338,1217
23,0,State,MADHYA PRADESH,Total,2402342,11342320,5908638,5433682
23,0,State,MADHYA PRADESH,Rural,1800346,8268002,4311490,3956512
23,0,State,MADHYA PRADESH,Urban,601996,3074318,1597148,1477170
23,418,DISTRICT,Sheopur ,Total,24540,108391,57838,50553
23,418,DISTRICT,Sheopur ,Rural,21225,91800,49091,42709
23,418,DISTRICT,Sheopur ,Urban,3315,16591,8747,7844
23,419,DISTRICT,Morena,Total,80994,421519,228548,192971
23,419,DISTRICT,Morena,Rural,64415,321530,174854,146676
23,419,DISTRICT,Morena,Urban,16579,99989,53694,46295
23,420,DISTRICT,Bhind,Total,68910,374799,204212,170587
23,420,DISTRICT,Bhind,Rural,53835,284499,155669,128830
23,420,DISTRICT,Bhind,Urban,15075,90300,48543,41757
23,421,DISTRICT,Gwalior,Total,73933,393068,210354,182714
23,421,DISTRICT,Gwalior,Rural,32315,161091,86564,74527
23,421,DISTRICT,Gwalior,Urban,41618,231977,123790,108187
23,422,DISTRICT,Datia,Total,42394,200270,107132,93138
23,422,DISTRICT,Datia,Rural,35695,164777,88263,76514
23,422,DISTRICT,Datia,Urban,6699,35493,18869,16624
23,423,DISTRICT,Shivpuri,Total,69067,321515,171565,149950
23,423,DISTRICT,Shivpuri,Rural,59991,273869,146477,127392
23,423,DISTRICT,Shivpuri,Urban,9076,47646,25088,22558
23,424,DISTRICT,Tikamgarh,Total,73951,361604,190666,170938
23,424,DISTRICT,Tikamgarh,Rural,64213,308062,162474,145588
23,424,DISTRICT,Tikamgarh,Urban,9738,53542,28192,25350
23,425,DISTRICT,Chhatarpur,Total,81692,405313,215258,190055
23,425,DISTRICT,Chhatarpur,Rural,69156,334176,177720,156456
23,425,DISTRICT,Chhatarpur,Urban,12536,71137,37538,33599
23,426,DISTRICT,Panna,Total,46406,207990,109421,98569
23,426,DISTRICT,Panna,Rural,41889,184883,97285,87598
23,426,DISTRICT,Panna,Urban,4517,23107,12136,10971
23,427,DISTRICT,Sagar,Total,109051,501630,266306,235324
23,427,DISTRICT,Sagar,Rural,79891,349843,186321,163522
23,427,DISTRICT,Sagar,Urban,29160,151787,79985,71802
23,428,DISTRICT,Damoh,Total,58375,246337,129877,116460
23,428,DISTRICT,Damoh,Rural,48109,195673,103224,92449
23,428,DISTRICT,Damoh,Urban,10266,50664,26653,24011
23,429,DISTRICT,Satna,Total,84624,398569,205987,192582
23,429,DISTRICT,Satna,Rural,69749,320757,165704,155053
23,429,DISTRICT,Satna,Urban,14875,77812,40283,37529
23,430,DISTRICT,Rewa,Total,83016,383508,198144,185364
23,430,DISTRICT,Rewa,Rural,73768,334878,172785,162093
23,430,DISTRICT,Rewa,Urban,9248,48630,25359,23271
23,431,DISTRICT,Umaria,Total,13312,58147,29902,28245
23,431,DISTRICT,Umaria,Rural,10581,45117,23089,22028
23,431,DISTRICT,Umaria,Urban,2731,13030,6813,6217
23,432,DISTRICT,Neemuch ,Total,25152,111162,56400,54762
23,432,DISTRICT,Neemuch ,Rural,18724,79193,39997,39196
23,432,DISTRICT,Neemuch ,Urban,6428,31969,16403,15566
23,433,DISTRICT,Mandsaur,Total,55733,249024,126822,122202
23,433,DISTRICT,Mandsaur,Rural,49314,218175,111292,106883
23,433,DISTRICT,Mandsaur,Urban,6419,30849,15530,15319
23,434,DISTRICT,Ratlam,Total,42044,198612,100629,97983
23,434,DISTRICT,Ratlam,Rural,32756,151828,76926,74902
23,434,DISTRICT,Ratlam,Urban,9288,46784,23703,23081
23,435,DISTRICT,Ujjain,Total,106710,523869,267235,256634
23,435,DISTRICT,Ujjain,Rural,77577,375705,191518,184187
23,435,DISTRICT,Ujjain,Urban,29133,148164,75717,72447
23,436,DISTRICT,Shajapur,Total,73664,353914,182961,170953
23,436,DISTRICT,Shajapur,Rural,65600,312523,161692,150831
23,436,DISTRICT,Shajapur,Urban,8064,41391,21269,20122
23,437,DISTRICT,Dewas,Total,60377,292007,150260,141747
23,437,DISTRICT,Dewas,Rural,45353,214408,110249,104159
23,437,DISTRICT,Dewas,Urban,15024,77599,40011,37588
23,438,DISTRICT,Dhar,Total,30971,145436,74291,71145
23,438,DISTRICT,Dhar,Rural,23336,109481,55518,53963
23,438,DISTRICT,Dhar,Urban,7635,35955,18773,17182
23,439,DISTRICT,Indore,Total,106270,545239,280184,265055
23,439,DISTRICT,Indore,Rural,32730,164465,83900,80565
23,439,DISTRICT,Indore,Urban,73540,380774,196284,184490
23,440,DISTRICT,Khargone (West Nimar),Total,46580,209091,107013,102078
23,440,DISTRICT,Khargone (West Nimar),Rural,40310,177708,90912,86796
23,440,DISTRICT,Khargone (West Nimar),Urban,6270,31383,16101,15282
23,441,DISTRICT,Barwani ,Total,17155,87991,44478,43513
23,441,DISTRICT,Barwani ,Rural,12533,64344,32479,31865
23,441,DISTRICT,Barwani ,Urban,4622,23647,11999,11648
23,442,DISTRICT,Rajgarh,Total,66466,295718,151260,144458
23,442,DISTRICT,Rajgarh,Rural,57602,249329,127721,121608
23,442,DISTRICT,Rajgarh,Urban,8864,46389,23539,22850
23,443,DISTRICT,Vidisha,Total,60381,292144,154504,137640
23,443,DISTRICT,Vidisha,Rural,49755,237791,126119,111672
23,443,DISTRICT,Vidisha,Urban,10626,54353,28385,25968
23,444,DISTRICT,Bhopal,Total,75355,357516,185902,171614
23,444,DISTRICT,Bhopal,Rural,19746,95945,50342,45603
23,444,DISTRICT,Bhopal,Urban,55609,261571,135560,126011
23,445,DISTRICT,Sehore,Total,56073,271281,141366,129915
23,445,DISTRICT,Sehore,Rural,48493,231398,120906,110492
23,445,DISTRICT,Sehore,Urban,7580,39883,20460,19423
23,446,DISTRICT,Raisen,Total,47879,225891,119226,106665
23,446,DISTRICT,Raisen,Rural,39092,183615,96859,86756
23,446,DISTRICT,Raisen,Urban,8787,42276,22367,19909
23,447,DISTRICT,Betul,Total,36323,159296,81621,77675
23,447,DISTRICT,Betul,Rural,25078,107791,55268,52523
23,447,DISTRICT,Betul,Urban,11245,51505,26353,25152
23,448,DISTRICT,Harda ,Total,19274,92865,48553,44312
23,448,DISTRICT,Harda ,Rural,15487,73519,38545,34974
23,448,DISTRICT,Harda ,Urban,3787,19346,10008,9338
23,449,DISTRICT,Hoshangabad,Total,43340,205007,107237,97770
23,449,DISTRICT,Hoshangabad,Rural,29758,138650,72832,65818
23,449,DISTRICT,Hoshangabad,Urban,13582,66357,34405,31952
23,450,DISTRICT,Katni ,Total,35474,155717,79369,76348
23,450,DISTRICT,Katni ,Rural,28545,121924,62077,59847
23,450,DISTRICT,Katni ,Urban,6929,33793,17292,16501
23,451,DISTRICT,Jabalpur,Total,75607,348029,179858,168171
23,451,DISTRICT,Jabalpur,Rural,32961,138878,71893,66985
23,451,DISTRICT,Jabalpur,Urban,42646,209151,107965,101186
23,452,DISTRICT,Narsimhapur,Total,43290,184155,96079,88076
23,452,DISTRICT,Narsimhapur,Rural,36747,153789,80330,73459
23,452,DISTRICT,Narsimhapur,Urban,6543,30366,15749,14617
23,453,DISTRICT,Dindori ,Total,10235,39782,20366,19416
23,453,DISTRICT,Dindori ,Rural,9768,37813,19384,18429
23,453,DISTRICT,Dindori ,Urban,467,1969,982,987
23,454,DISTRICT,Mandla,Total,11892,48425,24652,23773
23,454,DISTRICT,Mandla,Rural,9123,36205,18450,17755
23,454,DISTRICT,Mandla,Urban,2769,12220,6202,6018
23,455,DISTRICT,Chhindwara,Total,52431,232244,118465,113779
23,455,DISTRICT,Chhindwara,Rural,36170,158112,80981,77131
23,455,DISTRICT,Chhindwara,Urban,16261,74132,37484,36648
23,456,DISTRICT,Seoni,Total,31471,130797,66830,63967
23,456,DISTRICT,Seoni,Rural,27290,112436,57463,54973
23,456,DISTRICT,Seoni,Urban,4181,18361,9367,8994
23,457,DISTRICT,Balaghat,Total,32099,125426,61576,63850
23,457,DISTRICT,Balaghat,Rural,26061,99608,48756,50852
23,457,DISTRICT,Balaghat,Urban,6038,25818,12820,12998
23,458,DISTRICT,Guna,Total,38665,193115,100646,92469
23,458,DISTRICT,Guna,Rural,29319,142818,74562,68256
23,458,DISTRICT,Guna,Urban,9346,50297,26084,24213
23,459,DISTRICT,Ashoknagar,Total,36910,175764,92216,83548
23,459,DISTRICT,Ashoknagar,Rural,31983,149988,78784,71204
23,459,DISTRICT,Ashoknagar,Urban,4927,25776,13432,12344
23,460,DISTRICT,Shahdol,Total,21199,89733,45547,44186
23,460,DISTRICT,Shahdol,Rural,17174,69764,35351,34413
23,460,DISTRICT,Shahdol,Urban,4025,19969,10196,9773
23,461,DISTRICT,Anuppur,Total,17226,74385,37841,36544
23,461,DISTRICT,Anuppur,Rural,12163,49977,25180,24797
23,461,DISTRICT,Anuppur,Urban,5063,24408,12661,11747
23,462,DISTRICT,Sidhi,Total,27209,130202,66174,64028
23,462,DISTRICT,Sidhi,Rural,25341,120372,61138,59234
23,462,DISTRICT,Sidhi,Urban,1868,9830,5036,4794
23,463,DISTRICT,Singrauli,Total,31674,150664,77882,72782
23,463,DISTRICT,Singrauli,Rural,25731,120460,62171,58289
23,463,DISTRICT,Singrauli,Urban,5943,30204,15711,14493
23,464,DISTRICT,Jhabua,Total,3572,17427,8770,8657
23,464,DISTRICT,Jhabua,Rural,2379,11397,5724,5673
23,464,DISTRICT,Jhabua,Urban,1193,6030,3046,2984
23,465,DISTRICT,Alirajpur,Total,4841,26877,13481,13396
23,465,DISTRICT,Alirajpur,Rural,4201,23503,11776,11727
23,465,DISTRICT,Alirajpur,Urban,640,3374,1705,1669
23,466,DISTRICT,Khandwa (East Nimar),Total,34462,156601,80697,75904
23,466,DISTRICT,Khandwa (East Nimar),Rural,27840,122463,63348,59115
23,466,DISTRICT,Khandwa (East Nimar),Urban,6622,34138,17349,16789
23,467,DISTRICT,Burhanpur,Total,14073,64254,33037,31217
23,467,DISTRICT,Burhanpur,Rural,9474,41672,21527,20145
23,467,DISTRICT,Burhanpur,Urban,4599,22582,11510,11072
24,0,State,GUJARAT,Total,817281,4074447,2110331,1964116
24,0,State,GUJARAT,Rural,457937,2281573,1176107,1105466
24,0,State,GUJARAT,Urban,359344,1792874,934224,858650
24,468,DISTRICT,Kachchh,Total,49891,258859,133224,125635
24,468,DISTRICT,Kachchh,Rural,32600,170304,87247,83057
24,468,DISTRICT,Kachchh,Urban,17291,88555,45977,42578
24,469,DISTRICT,Banas Kantha,Total,58813,327460,169288,158172
24,469,DISTRICT,Banas Kantha,Rural,51445,287937,148611,139326
24,469,DISTRICT,Banas Kantha,Urban,7368,39523,20677,18846
24,470,DISTRICT,Patan  ,Total,23680,123408,64190,59218
24,470,DISTRICT,Patan  ,Rural,18494,96923,50370,46553
24,470,DISTRICT,Patan  ,Urban,5186,26485,13820,12665
24,471,DISTRICT,Mahesana,Total,33355,162288,84470,77818
24,471,DISTRICT,Mahesana,Rural,24586,118710,61672,57038
24,471,DISTRICT,Mahesana,Urban,8769,43578,22798,20780
24,472,DISTRICT,Sabar Kantha,Total,39591,187685,96527,91158
24,472,DISTRICT,Sabar Kantha,Rural,33677,159214,81874,77340
24,472,DISTRICT,Sabar Kantha,Urban,5914,28471,14653,13818
24,473,DISTRICT,Gandhinagar,Total,22824,108608,56919,51689
24,473,DISTRICT,Gandhinagar,Rural,8832,40454,21162,19292
24,473,DISTRICT,Gandhinagar,Urban,13992,68154,35757,32397
24,474,DISTRICT,Ahmadabad,Total,151637,759483,399075,360408
24,474,DISTRICT,Ahmadabad,Rural,24688,118502,61988,56514
24,474,DISTRICT,Ahmadabad,Urban,126949,640981,337087,303894
24,475,DISTRICT,Surendranagar,Total,35172,179461,93427,86034
24,475,DISTRICT,Surendranagar,Rural,25145,128019,66538,61481
24,475,DISTRICT,Surendranagar,Urban,10027,51442,26889,24553
24,476,DISTRICT,Rajkot,Total,57311,290169,149782,140387
24,476,DISTRICT,Rajkot,Rural,29405,147979,76241,71738
24,476,DISTRICT,Rajkot,Urban,27906,142190,73541,68649
24,477,DISTRICT,Jamnagar,Total,34018,173895,89597,84298
24,477,DISTRICT,Jamnagar,Rural,19365,99378,51012,48366
24,477,DISTRICT,Jamnagar,Urban,14653,74517,38585,35932
24,478,DISTRICT,Porbandar ,Total,11087,51830,26607,25223
24,478,DISTRICT,Porbandar ,Rural,6280,29068,14955,14113
24,478,DISTRICT,Porbandar ,Urban,4807,22762,11652,11110
24,479,DISTRICT,Junagadh,Total,52384,265793,136319,129474
24,479,DISTRICT,Junagadh,Rural,40173,204153,104726,99427
24,479,DISTRICT,Junagadh,Urban,12211,61640,31593,30047
24,480,DISTRICT,Amreli,Total,25418,132915,68518,64397
24,480,DISTRICT,Amreli,Rural,20816,109351,56358,52993
24,480,DISTRICT,Amreli,Urban,4602,23564,12160,11404
24,481,DISTRICT,Bhavnagar,Total,29733,157034,80827,76207
24,481,DISTRICT,Bhavnagar,Rural,16647,88671,45615,43056
24,481,DISTRICT,Bhavnagar,Urban,13086,68363,35212,33151
24,482,DISTRICT,Anand  ,Total,22491,104465,54476,49989
24,482,DISTRICT,Anand  ,Rural,16489,74755,39026,35729
24,482,DISTRICT,Anand  ,Urban,6002,29710,15450,14260
24,483,DISTRICT,Kheda,Total,24545,115631,59734,55897
24,483,DISTRICT,Kheda,Rural,18731,86794,44935,41859
24,483,DISTRICT,Kheda,Urban,5814,28837,14799,14038
24,484,DISTRICT,Panch Mahals,Total,20437,100446,51278,49168
24,484,DISTRICT,Panch Mahals,Rural,16986,83082,42398,40684
24,484,DISTRICT,Panch Mahals,Urban,3451,17364,8880,8484
24,485,DISTRICT,Dohad  ,Total,7449,41444,20680,20764
24,485,DISTRICT,Dohad  ,Rural,5579,31647,15751,15896
24,485,DISTRICT,Dohad  ,Urban,1870,9797,4929,4868
24,486,DISTRICT,Vadodara,Total,48333,221629,114602,107027
24,486,DISTRICT,Vadodara,Rural,19059,83102,42935,40167
24,486,DISTRICT,Vadodara,Urban,29274,138527,71667,66860
24,487,DISTRICT,Narmada,Total,2168,8733,4465,4268
24,487,DISTRICT,Narmada,Rural,1593,5954,3036,2918
24,487,DISTRICT,Narmada,Urban,575,2779,1429,1350
24,488,DISTRICT,Bharuch,Total,14237,62235,31979,30256
24,488,DISTRICT,Bharuch,Rural,8307,35364,18086,17278
24,488,DISTRICT,Bharuch,Urban,5930,26871,13893,12978
24,489,DISTRICT,The Dangs,Total,214,992,490,502
24,489,DISTRICT,The Dangs,Rural,39,151,80,71
24,489,DISTRICT,The Dangs,Urban,175,841,410,431
24,490,DISTRICT,Navsari  ,Total,8330,35464,17959,17505
24,490,DISTRICT,Navsari  ,Rural,4346,17348,8712,8636
24,490,DISTRICT,Navsari  ,Urban,3984,18116,9247,8869
24,491,DISTRICT,Valsad,Total,8422,38237,19557,18680
24,491,DISTRICT,Valsad,Rural,4666,20777,10537,10240
24,491,DISTRICT,Valsad,Urban,3756,17460,9020,8440
24,492,DISTRICT,Surat,Total,33928,158115,82202,75913
24,492,DISTRICT,Surat,Rural,8800,38640,19559,19081
24,492,DISTRICT,Surat,Urban,25128,119475,62643,56832
24,493,DISTRICT,Tapi,Total,1813,8168,4139,4029
24,493,DISTRICT,Tapi,Rural,1189,5296,2683,2613
24,493,DISTRICT,Tapi,Urban,624,2872,1456,1416
25,0,State,DAMAN & DIU,Total,1288,6124,3151,2973
25,0,State,DAMAN & DIU,Rural,455,2167,1108,1059
25,0,State,DAMAN & DIU,Urban,833,3957,2043,1914
25,494,DISTRICT,Diu,Total,386,1862,927,935
25,494,DISTRICT,Diu,Rural,116,493,258,235
25,494,DISTRICT,Diu,Urban,270,1369,669,700
25,495,DISTRICT,Daman,Total,902,4262,2224,2038
25,495,DISTRICT,Daman,Rural,339,1674,850,824
25,495,DISTRICT,Daman,Urban,563,2588,1374,1214
26,0,State,DADRA & NAGAR HAVELI,Total,1353,6186,3339,2847
26,0,State,DADRA & NAGAR HAVELI,Rural,325,1296,771,525
26,0,State,DADRA & NAGAR HAVELI,Urban,1028,4890,2568,2322
26,496,DISTRICT,Dadra & Nagar Haveli,Total,1353,6186,3339,2847
26,496,DISTRICT,Dadra & Nagar Haveli,Rural,325,1296,771,525
26,496,DISTRICT,Dadra & Nagar Haveli,Urban,1028,4890,2568,2322
27,0,State,MAHARASHTRA,Total,2898245,13275898,6767759,6508139
27,0,State,MAHARASHTRA,Rural,1675570,7494819,3825053,3669766
27,0,State,MAHARASHTRA,Urban,1222675,5781079,2942706,2838373
27,497,DISTRICT,Nandurbar,Total,9880,47985,24273,23712
27,497,DISTRICT,Nandurbar,Rural,6538,30550,15453,15097
27,497,DISTRICT,Nandurbar,Urban,3342,17435,8820,8615
27,498,DISTRICT,Dhule,Total,25499,127571,65068,62503
27,498,DISTRICT,Dhule,Rural,16671,82299,42087,40212
27,498,DISTRICT,Dhule,Urban,8828,45272,22981,22291
27,499,DISTRICT,Jalgaon,Total,84303,389273,199427,189846
27,499,DISTRICT,Jalgaon,Rural,59865,267718,137458,130260
27,499,DISTRICT,Jalgaon,Urban,24438,121555,61969,59586
27,500,DISTRICT,Buldana,Total,105037,470895,241445,229450
27,500,DISTRICT,Buldana,Rural,89298,395137,202996,192141
27,500,DISTRICT,Buldana,Urban,15739,75758,38449,37309
27,501,DISTRICT,Akola,Total,82780,364059,186244,177815
27,501,DISTRICT,Akola,Rural,59926,253575,130266,123309
27,501,DISTRICT,Akola,Urban,22854,110484,55978,54506
27,502,DISTRICT,Washim,Total,51458,229462,117867,111595
27,502,DISTRICT,Washim,Rural,45463,200187,103178,97009
27,502,DISTRICT,Washim,Urban,5995,29275,14689,14586
27,503,DISTRICT,Amravati,Total,121148,506374,259398,246976
27,503,DISTRICT,Amravati,Rural,86124,346056,178148,167908
27,503,DISTRICT,Amravati,Urban,35024,160318,81250,79068
27,504,DISTRICT,Wardha,Total,47092,188830,96569,92261
27,504,DISTRICT,Wardha,Rural,29702,114889,59201,55688
27,504,DISTRICT,Wardha,Urban,17390,73941,37368,36573
27,505,DISTRICT,Nagpur,Total,198305,867713,439205,428508
27,505,DISTRICT,Nagpur,Rural,56543,234062,119694,114368
27,505,DISTRICT,Nagpur,Urban,141762,633651,319511,314140
27,506,DISTRICT,Bhandara,Total,49898,200372,100421,99951
27,506,DISTRICT,Bhandara,Rural,39466,155163,77939,77224
27,506,DISTRICT,Bhandara,Urban,10432,45209,22482,22727
27,507,DISTRICT,Gondiya,Total,42569,175961,87434,88527
27,507,DISTRICT,Gondiya,Rural,33535,135393,67401,67992
27,507,DISTRICT,Gondiya,Urban,9034,40568,20033,20535
27,508,DISTRICT,Gadchiroli,Total,31760,120745,61041,59704
27,508,DISTRICT,Gadchiroli,Rural,27082,101879,51541,50338
27,508,DISTRICT,Gadchiroli,Urban,4678,18866,9500,9366
27,509,DISTRICT,Chandrapur,Total,87554,348365,176898,171467
27,509,DISTRICT,Chandrapur,Rural,50247,187643,95203,92440
27,509,DISTRICT,Chandrapur,Urban,37307,160722,81695,79027
27,510,DISTRICT,Yavatmal,Total,80643,328518,167009,161509
27,510,DISTRICT,Yavatmal,Rural,62747,249800,127461,122339
27,510,DISTRICT,Yavatmal,Urban,17896,78718,39548,39170
27,511,DISTRICT,Nanded,Total,128792,640483,328797,311686
27,511,DISTRICT,Nanded,Rural,97314,473434,243159,230275
27,511,DISTRICT,Nanded,Urban,31478,167049,85638,81411
27,512,DISTRICT,Hingoli,Total,36955,182565,93379,89186
27,512,DISTRICT,Hingoli,Rural,32999,161751,82844,78907
27,512,DISTRICT,Hingoli,Urban,3956,20814,10535,10279
27,513,DISTRICT,Parbhani,Total,49770,247308,125883,121425
27,513,DISTRICT,Parbhani,Rural,35911,172674,88291,84383
27,513,DISTRICT,Parbhani,Urban,13859,74634,37592,37042
27,514,DISTRICT,Jalna,Total,55603,272266,138957,133309
27,514,DISTRICT,Jalna,Rural,46987,226345,115749,110596
27,514,DISTRICT,Jalna,Urban,8616,45921,23208,22713
27,515,DISTRICT,Aurangabad,Total,110475,539368,277228,262140
27,515,DISTRICT,Aurangabad,Rural,52090,246659,126700,119959
27,515,DISTRICT,Aurangabad,Urban,58385,292709,150528,142181
27,516,DISTRICT,Nashik,Total,114838,554687,282213,272474
27,516,DISTRICT,Nashik,Rural,47138,231171,117824,113347
27,516,DISTRICT,Nashik,Urban,67700,323516,164389,159127
27,517,DISTRICT,Thane,Total,161323,730089,377885,352204
27,517,DISTRICT,Thane,Rural,19306,84982,43891,41091
27,517,DISTRICT,Thane,Urban,142017,645107,333994,311113
27,518,DISTRICT,Mumbai Suburban,Total,122482,583302,300291,283011
27,518,DISTRICT,Mumbai Suburban,Rural,0,0,0,0
27,518,DISTRICT,Mumbai Suburban,Urban,122482,583302,300291,283011
27,519,DISTRICT,Mumbai,Total,44740,219934,111564,108370
27,519,DISTRICT,Mumbai,Rural,0,0,0,0
27,519,DISTRICT,Mumbai,Urban,44740,219934,111564,108370
27,520,DISTRICT,Raigarh,Total,30282,134952,67980,66972
27,520,DISTRICT,Raigarh,Rural,14505,64338,31985,32353
27,520,DISTRICT,Raigarh,Urban,15777,70614,35995,34619
27,521,DISTRICT,Pune,Total,255462,1180703,602755,577948
27,521,DISTRICT,Pune,Rural,79339,361029,185088,175941
27,521,DISTRICT,Pune,Urban,176123,819674,417667,402007
27,522,DISTRICT,Ahmadnagar,Total,119831,573698,291521,282177
27,522,DISTRICT,Ahmadnagar,Rural,93390,443302,225820,217482
27,522,DISTRICT,Ahmadnagar,Urban,26441,130396,65701,64695
27,523,DISTRICT,Bid,Total,74523,351254,179777,171477
27,523,DISTRICT,Bid,Rural,60246,278869,143031,135838
27,523,DISTRICT,Bid,Urban,14277,72385,36746,35639
27,524,DISTRICT,Latur,Total,95227,480913,247918,232995
27,524,DISTRICT,Latur,Rural,74670,369609,190913,178696
27,524,DISTRICT,Latur,Urban,20557,111304,57005,54299
27,525,DISTRICT,Osmanabad,Total,56988,265184,136354,128830
27,525,DISTRICT,Osmanabad,Rural,48455,221325,113813,107512
27,525,DISTRICT,Osmanabad,Urban,8533,43859,22541,21318
27,526,DISTRICT,Solapur,Total,133735,649745,331960,317785
27,526,DISTRICT,Solapur,Rural,93568,443181,227928,215253
27,526,DISTRICT,Solapur,Urban,40167,206564,104032,102532
27,527,DISTRICT,Satara,Total,71791,323236,161703,161533
27,527,DISTRICT,Satara,Rural,55872,247575,123808,123767
27,527,DISTRICT,Satara,Urban,15919,75661,37895,37766
27,528,DISTRICT,Ratnagiri,Total,16533,66948,31967,34981
27,528,DISTRICT,Ratnagiri,Rural,14312,57524,27217,30307
27,528,DISTRICT,Ratnagiri,Urban,2221,9424,4750,4674
27,529,DISTRICT,Sindhudurg,Total,14162,55586,26830,28756
27,529,DISTRICT,Sindhudurg,Rural,12481,48709,23397,25312
27,529,DISTRICT,Sindhudurg,Urban,1681,6877,3433,3444
27,530,DISTRICT,Kolhapur,Total,109910,504461,253390,251071
27,530,DISTRICT,Kolhapur,Rural,78219,355641,178623,177018
27,530,DISTRICT,Kolhapur,Urban,31691,148820,74767,74053
27,531,DISTRICT,Sangli,Total,76897,353093,177108,175985
27,531,DISTRICT,Sangli,Rural,55561,252350,126946,125404
27,531,DISTRICT,Sangli,Urban,21336,100743,50162,50581
28,0,State,ANDHRA PRADESH,Total,3429973,13878078,6913047,6965031
28,0,State,ANDHRA PRADESH,Rural,2708521,10846333,5417474,5428859
28,0,State,ANDHRA PRADESH,Urban,721452,3031745,1495573,1536172
28,532,DISTRICT,Adilabad,Total,119756,488596,242844,245752
28,532,DISTRICT,Adilabad,Rural,91507,368490,182451,186039
28,532,DISTRICT,Adilabad,Urban,28249,120106,60393,59713
28,533,DISTRICT,Nizamabad,Total,89598,371074,178798,192276
28,533,DISTRICT,Nizamabad,Rural,78946,323425,155816,167609
28,533,DISTRICT,Nizamabad,Urban,10652,47649,22982,24667
28,534,DISTRICT,Karimnagar,Total,184163,709757,352481,357276
28,534,DISTRICT,Karimnagar,Rural,154330,587484,291431,296053
28,534,DISTRICT,Karimnagar,Urban,29833,122273,61050,61223
28,535,DISTRICT,Medak,Total,119950,537947,266413,271534
28,535,DISTRICT,Medak,Rural,102461,461017,228175,232842
28,535,DISTRICT,Medak,Urban,17489,76930,38238,38692
28,536,DISTRICT,Hyderabad,Total,57750,247927,124313,123614
28,536,DISTRICT,Hyderabad,Rural,0,0,0,0
28,536,DISTRICT,Hyderabad,Urban,57750,247927,124313,123614
28,537,DISTRICT,Rangareddy,Total,149880,652042,328011,324031
28,537,DISTRICT,Rangareddy,Rural,73588,325517,163576,161941
28,537,DISTRICT,Rangareddy,Urban,76292,326525,164435,162090
28,538,DISTRICT,Mahbubnagar,Total,152734,708954,356099,352855
28,538,DISTRICT,Mahbubnagar,Rural,141109,651273,327589,323684
28,538,DISTRICT,Mahbubnagar,Urban,11625,57681,28510,29171
28,539,DISTRICT,Nalgonda,Total,156603,637385,318359,319026
28,539,DISTRICT,Nalgonda,Rural,136880,550732,276394,274338
28,539,DISTRICT,Nalgonda,Urban,19723,86653,41965,44688
28,540,DISTRICT,Warangal,Total,151556,616102,307709,308393
28,540,DISTRICT,Warangal,Rural,115061,461297,230559,230738
28,540,DISTRICT,Warangal,Urban,36495,154805,77150,77655
28,541,DISTRICT,Khammam,Total,123602,462896,229905,232991
28,541,DISTRICT,Khammam,Rural,99116,366888,183331,183557
28,541,DISTRICT,Khammam,Urban,24486,96008,46574,49434
28,542,DISTRICT,Srikakulam,Total,65323,255664,125214,130450
28,542,DISTRICT,Srikakulam,Rural,55368,214824,105721,109103
28,542,DISTRICT,Srikakulam,Urban,9955,40840,19493,21347
28,543,DISTRICT,Vizianagaram,Total,63569,247728,121493,126235
28,543,DISTRICT,Vizianagaram,Rural,49742,190373,93902,96471
28,543,DISTRICT,Vizianagaram,Urban,13827,57355,27591,29764
28,544,DISTRICT,Visakhapatnam,Total,83516,329486,162873,166613
28,544,DISTRICT,Visakhapatnam,Rural,39755,151980,75154,76826
28,544,DISTRICT,Visakhapatnam,Urban,43761,177506,87719,89787
28,545,DISTRICT,East Godavari,Total,252583,945269,468883,476386
28,545,DISTRICT,East Godavari,Rural,211521,785984,391519,394465
28,545,DISTRICT,East Godavari,Urban,41062,159285,77364,81921
28,546,DISTRICT,West Godavari,Total,219250,811698,403693,408005
28,546,DISTRICT,West Godavari,Rural,193465,710703,355154,355549
28,546,DISTRICT,West Godavari,Urban,25785,100995,48539,52456
28,547,DISTRICT,Krishna,Total,233868,871063,435412,435651
28,547,DISTRICT,Krishna,Rural,180302,665621,333803,331818
28,547,DISTRICT,Krishna,Urban,53566,205442,101609,103833
28,548,DISTRICT,Guntur,Total,247861,957407,476333,481074
28,548,DISTRICT,Guntur,Rural,194624,740117,370856,369261
28,548,DISTRICT,Guntur,Urban,53237,217290,105477,111813
28,549,DISTRICT,Prakasam,Total,184646,787861,397242,390619
28,549,DISTRICT,Prakasam,Rural,163317,698090,352889,345201
28,549,DISTRICT,Prakasam,Urban,21329,89771,44353,45418
28,550,DISTRICT,Sri Potti Sriramulu Nellore,Total,172098,666588,332673,333915
28,550,DISTRICT,Sri Potti Sriramulu Nellore,Rural,142618,544770,272522,272248
28,550,DISTRICT,Sri Potti Sriramulu Nellore,Urban,29480,121818,60151,61667
28,551,DISTRICT,Y.S.R.,Total,114888,465794,232123,233671
28,551,DISTRICT,Y.S.R.,Rural,89225,355350,177589,177761
28,551,DISTRICT,Y.S.R.,Urban,25663,110444,54534,55910
28,552,DISTRICT,Kurnool,Total,159796,737945,370215,367730
28,552,DISTRICT,Kurnool,Rural,124289,569045,287498,281547
28,552,DISTRICT,Kurnool,Urban,35507,168900,82717,86183
28,553,DISTRICT,Anantapur,Total,134043,583135,292379,290756
28,553,DISTRICT,Anantapur,Rural,110182,475929,239604,236325
28,553,DISTRICT,Anantapur,Urban,23861,107206,52775,54431
28,554,DISTRICT,Chittoor,Total,192940,785760,389582,396178
28,554,DISTRICT,Chittoor,Rural,161115,647424,321941,325483
28,554,DISTRICT,Chittoor,Urban,31825,138336,67641,70695
29,0,State,KARNATAKA,Total,2178501,10474992,5264545,5210447
29,0,State,KARNATAKA,Rural,1548783,7495763,3771506,3724257
29,0,State,KARNATAKA,Urban,629718,2979229,1493039,1486190
29,555,DISTRICT,Belgaum,Total,119946,577418,289096,288322
29,555,DISTRICT,Belgaum,Rural,92727,448375,225418,222957
29,555,DISTRICT,Belgaum,Urban,27219,129043,63678,65365
29,556,DISTRICT,Bagalkot ,Total,59093,319149,158135,161014
29,556,DISTRICT,Bagalkot ,Rural,43771,238014,118054,119960
29,556,DISTRICT,Bagalkot ,Urban,15322,81135,40081,41054
29,557,DISTRICT,Bijapur,Total,78045,442773,226440,216333
29,557,DISTRICT,Bijapur,Rural,63484,364088,186568,177520
29,557,DISTRICT,Bijapur,Urban,14561,78685,39872,38813
29,558,DISTRICT,Bidar,Total,74109,399785,204280,195505
29,558,DISTRICT,Bidar,Rural,61127,330419,168884,161535
29,558,DISTRICT,Bidar,Urban,12982,69366,35396,33970
29,559,DISTRICT,Raichur,Total,73360,400933,200359,200574
29,559,DISTRICT,Raichur,Rural,56773,313581,156829,156752
29,559,DISTRICT,Raichur,Urban,16587,87352,43530,43822
29,560,DISTRICT,Koppal,Total,47949,258608,129341,129267
29,560,DISTRICT,Koppal,Rural,41145,222935,111858,111077
29,560,DISTRICT,Koppal,Urban,6804,35673,17483,18190
29,561,DISTRICT,Gadag,Total,33104,174196,87745,86451
29,561,DISTRICT,Gadag,Rural,23979,127515,64485,63030
29,561,DISTRICT,Gadag,Urban,9125,46681,23260,23421
29,562,DISTRICT,Dharwad,Total,35584,177855,89137,88718
29,562,DISTRICT,Dharwad,Rural,14275,71387,36366,35021
29,562,DISTRICT,Dharwad,Urban,21309,106468,52771,53697
29,563,DISTRICT,Uttara Kannada,Total,26617,116431,57841,58590
29,563,DISTRICT,Uttara Kannada,Rural,18219,78859,39392,39467
29,563,DISTRICT,Uttara Kannada,Urban,8398,37572,18449,19123
29,564,DISTRICT,Haveri,Total,45065,219976,112212,107764
29,564,DISTRICT,Haveri,Rural,38648,188161,96191,91970
29,564,DISTRICT,Haveri,Urban,6417,31815,16021,15794
29,565,DISTRICT,Bellary,Total,97915,517409,258582,258827
29,565,DISTRICT,Bellary,Rural,67740,366016,183550,182466
29,565,DISTRICT,Bellary,Urban,30175,151393,75032,76361
29,566,DISTRICT,Chitradurga,Total,80911,389117,196819,192298
29,566,DISTRICT,Chitradurga,Rural,69311,333571,169160,164411
29,566,DISTRICT,Chitradurga,Urban,11600,55546,27659,27887
29,567,DISTRICT,Davanagere,Total,81369,392595,198299,194296
29,567,DISTRICT,Davanagere,Rural,65605,315926,159704,156222
29,567,DISTRICT,Davanagere,Urban,15764,76669,38595,38074
29,568,DISTRICT,Shimoga,Total,70726,308158,153546,154612
29,568,DISTRICT,Shimoga,Rural,51960,225316,112674,112642
29,568,DISTRICT,Shimoga,Urban,18766,82842,40872,41970
29,569,DISTRICT,Udupi,Total,15329,75429,36988,38441
29,569,DISTRICT,Udupi,Rural,11370,55996,27453,28543
29,569,DISTRICT,Udupi,Urban,3959,19433,9535,9898
29,570,DISTRICT,Chikmagalur,Total,59296,253651,125016,128635
29,570,DISTRICT,Chikmagalur,Rural,51432,218406,107779,110627
29,570,DISTRICT,Chikmagalur,Urban,7864,35245,17237,18008
29,571,DISTRICT,Tumkur,Total,119732,506901,254535,252366
29,571,DISTRICT,Tumkur,Rural,102114,429957,215949,214008
29,571,DISTRICT,Tumkur,Urban,17618,76944,38586,38358
29,572,DISTRICT,Bangalore,Total,266943,1198385,607725,590660
29,572,DISTRICT,Bangalore,Rural,45424,199870,101739,98131
29,572,DISTRICT,Bangalore,Urban,221519,998515,505986,492529
29,573,DISTRICT,Mandya,Total,61423,265294,131675,133619
29,573,DISTRICT,Mandya,Rural,51546,221943,110241,111702
29,573,DISTRICT,Mandya,Urban,9877,43351,21434,21917
29,574,DISTRICT,Hassan,Total,79381,345031,169961,175070
29,574,DISTRICT,Hassan,Rural,68844,298013,146830,151183
29,574,DISTRICT,Hassan,Urban,10537,47018,23131,23887
29,575,DISTRICT,Dakshina Kannada,Total,31290,148178,73324,74854
29,575,DISTRICT,Dakshina Kannada,Rural,21816,102737,51082,51655
29,575,DISTRICT,Dakshina Kannada,Urban,9474,45441,22242,23199
29,576,DISTRICT,Kodagu,Total,18619,73584,35759,37825
29,576,DISTRICT,Kodagu,Rural,16435,64618,31359,33259
29,576,DISTRICT,Kodagu,Urban,2184,8966,4400,4566
29,577,DISTRICT,Mysore,Total,119603,536643,269331,267312
29,577,DISTRICT,Mysore,Rural,85398,380388,191232,189156
29,577,DISTRICT,Mysore,Urban,34205,156255,78099,78156
29,578,DISTRICT,Chamarajanagar,Total,58485,259445,130894,128551
29,578,DISTRICT,Chamarajanagar,Rural,50342,221650,111886,109764
29,578,DISTRICT,Chamarajanagar,Urban,8143,37795,19008,18787
29,579,DISTRICT,Gulbarga,Total,114633,648782,330091,318691
29,579,DISTRICT,Gulbarga,Rural,84760,489697,249515,240182
29,579,DISTRICT,Gulbarga,Urban,29873,159085,80576,78509
29,580,DISTRICT,Yadgir,Total,44848,273315,137204,136111
29,580,DISTRICT,Yadgir,Rural,39312,241721,121312,120409
29,580,DISTRICT,Yadgir,Urban,5536,31594,15892,15702
29,581,DISTRICT,Kolar,Total,99650,465867,232546,233321
29,581,DISTRICT,Kolar,Rural,69947,327424,164018,163406
29,581,DISTRICT,Kolar,Urban,29703,138443,68528,69915
29,582,DISTRICT,Chikkaballapura,Total,70191,312565,157628,154937
29,582,DISTRICT,Chikkaballapura,Rural,61792,272891,137654,135237
29,582,DISTRICT,Chikkaballapura,Urban,8399,39674,19974,19700
29,583,DISTRICT,Bangalore Rural,Total,47516,213700,107424,106276
29,583,DISTRICT,Bangalore Rural,Rural,40414,181501,91184,90317
29,583,DISTRICT,Bangalore Rural,Urban,7102,32199,16240,15959
29,584,DISTRICT,Ramanagara,Total,47769,203819,102612,101207
29,584,DISTRICT,Ramanagara,Rural,39073,164788,83140,81648
29,584,DISTRICT,Ramanagara,Urban,8696,39031,19472,19559
30,0,State,GOA,Total,5545,25449,12627,12822
30,0,State,GOA,Rural,2136,9461,4634,4827
30,0,State,GOA,Urban,3409,15988,7993,7995
30,585,DISTRICT,North Goa,Total,3871,17606,8712,8894
30,585,DISTRICT,North Goa,Rural,1770,7843,3837,4006
30,585,DISTRICT,North Goa,Urban,2101,9763,4875,4888
30,586,DISTRICT,South Goa,Total,1674,7843,3915,3928
30,586,DISTRICT,South Goa,Rural,366,1618,797,821
30,586,DISTRICT,South Goa,Urban,1308,6225,3118,3107
32,0,State,KERALA,Total,725582,3039573,1477808,1561765
32,0,State,KERALA,Rural,437305,1818281,883819,934462
32,0,State,KERALA,Urban,288277,1221292,593989,627303
32,588,DISTRICT,Kasaragod,Total,11358,53283,26385,26898
32,588,DISTRICT,Kasaragod,Rural,7336,34522,17207,17315
32,588,DISTRICT,Kasaragod,Urban,4022,18761,9178,9583
32,589,DISTRICT,Kannur,Total,19367,83350,40260,43090
32,589,DISTRICT,Kannur,Rural,5733,23562,11505,12057
32,589,DISTRICT,Kannur,Urban,13634,59788,28755,31033
32,590,DISTRICT,Wayanad,Total,8196,32578,16406,16172
32,590,DISTRICT,Wayanad,Rural,7628,30378,15281,15097
32,590,DISTRICT,Wayanad,Urban,568,2200,1125,1075
32,591,DISTRICT,Kozhikode,Total,47314,199191,97279,101912
32,591,DISTRICT,Kozhikode,Rural,18239,75490,37017,38473
32,591,DISTRICT,Kozhikode,Urban,29075,123701,60262,63439
32,592,DISTRICT,Malappuram,Total,64083,308266,151557,156709
32,592,DISTRICT,Malappuram,Rural,40233,192270,94367,97903
32,592,DISTRICT,Malappuram,Urban,23850,115996,57190,58806
32,593,DISTRICT,Palakkad,Total,92121,403833,197451,206382
32,593,DISTRICT,Palakkad,Rural,73970,322951,157892,165059
32,593,DISTRICT,Palakkad,Urban,18151,80882,39559,41323
32,594,DISTRICT,Thrissur,Total,78235,324350,156480,167870
32,594,DISTRICT,Thrissur,Rural,29870,121839,58615,63224
32,594,DISTRICT,Thrissur,Urban,48365,202511,97865,104646
32,595,DISTRICT,Ernakulam,Total,66754,268411,131573,136838
32,595,DISTRICT,Ernakulam,Rural,25693,102403,50258,52145
32,595,DISTRICT,Ernakulam,Urban,41061,166008,81315,84693
32,596,DISTRICT,Idukki ,Total,37227,145486,72399,73087
32,596,DISTRICT,Idukki ,Rural,36682,143340,71354,71986
32,596,DISTRICT,Idukki ,Urban,545,2146,1045,1101
32,597,DISTRICT,Kottayam,Total,37341,153909,75503,78406
32,597,DISTRICT,Kottayam,Rural,29123,119360,58557,60803
32,597,DISTRICT,Kottayam,Urban,8218,34549,16946,17603
32,598,DISTRICT,Alappuzha,Total,49533,201211,97183,104028
32,598,DISTRICT,Alappuzha,Rural,27446,111931,53941,57990
32,598,DISTRICT,Alappuzha,Urban,22087,89280,43242,46038
32,599,DISTRICT,Pathanamthitta,Total,41187,164465,78942,85523
32,599,DISTRICT,Pathanamthitta,Rural,38138,151844,72784,79060
32,599,DISTRICT,Pathanamthitta,Urban,3049,12621,6158,6463
32,600,DISTRICT,Kollam,Total,80390,328263,157801,170462
32,600,DISTRICT,Kollam,Rural,52272,208474,99761,108713
32,600,DISTRICT,Kollam,Urban,28118,119789,58040,61749
32,601,DISTRICT,Thiruvananthapuram,Total,92476,372977,178589,194388
32,601,DISTRICT,Thiruvananthapuram,Rural,44942,179917,85280,94637
32,601,DISTRICT,Thiruvananthapuram,Urban,47534,193060,93309,99751
33,0,State,TAMIL NADU,Total,3591953,14438445,7204687,7233758
33,0,State,TAMIL NADU,Rural,2362864,9475475,4736003,4739472
33,0,State,TAMIL NADU,Urban,1229089,4962970,2468684,2494286
33,602,DISTRICT,Thiruvallur,Total,205398,821646,410526,411120
33,602,DISTRICT,Thiruvallur,Rural,113975,451999,225349,226650
33,602,DISTRICT,Thiruvallur,Urban,91423,369647,185177,184470
33,603,DISTRICT,Chennai,Total,185889,779667,389001,390666
33,603,DISTRICT,Chennai,Rural,0,0,0,0
33,603,DISTRICT,Chennai,Urban,185889,779667,389001,390666
33,604,DISTRICT,Kancheepuram,Total,231254,948081,474264,473817
33,604,DISTRICT,Kancheepuram,Rural,134451,550997,275720,275277
33,604,DISTRICT,Kancheepuram,Urban,96803,397084,198544,198540
33,605,DISTRICT,Vellore,Total,197803,860212,424668,435544
33,605,DISTRICT,Vellore,Rural,127600,547724,271717,276007
33,605,DISTRICT,Vellore,Urban,70203,312488,152951,159537
33,606,DISTRICT,Tiruvannamalai,Total,126887,565329,282615,282714
33,606,DISTRICT,Tiruvannamalai,Rural,111499,493925,247457,246468
33,606,DISTRICT,Tiruvannamalai,Urban,15388,71404,35158,36246
33,607,DISTRICT,Viluppuram,Total,221874,1015716,510869,504847
33,607,DISTRICT,Viluppuram,Rural,201987,924896,465644,459252
33,607,DISTRICT,Viluppuram,Urban,19887,90820,45225,45595
33,608,DISTRICT,Salem,Total,147462,580512,294062,286450
33,608,DISTRICT,Salem,Rural,82136,318693,162603,156090
33,608,DISTRICT,Salem,Urban,65326,261819,131459,130360
33,609,DISTRICT,Namakkal   ,Total,94752,345392,173973,171419
33,609,DISTRICT,Namakkal   ,Rural,67924,244098,122948,121150
33,609,DISTRICT,Namakkal   ,Urban,26828,101294,51025,50269
33,610,DISTRICT,Erode,Total,106833,369483,184408,185075
33,610,DISTRICT,Erode,Rural,63311,215316,107703,107613
33,610,DISTRICT,Erode,Urban,43522,154167,76705,77462
33,611,DISTRICT,The Nilgiris,Total,64145,235878,115917,119961
33,611,DISTRICT,The Nilgiris,Rural,24360,86753,42691,44062
33,611,DISTRICT,The Nilgiris,Urban,39785,149125,73226,75899
33,612,DISTRICT,Dindigul,Total,115598,452376,225573,226803
33,612,DISTRICT,Dindigul,Rural,80031,310601,155203,155398
33,612,DISTRICT,Dindigul,Urban,35567,141775,70370,71405
33,613,DISTRICT,Karur ,Total,58852,221385,108809,112576
33,613,DISTRICT,Karur ,Rural,40523,152799,75149,77650
33,613,DISTRICT,Karur ,Urban,18329,68586,33660,34926
33,614,DISTRICT,Tiruchirappalli,Total,118304,466561,230790,235771
33,614,DISTRICT,Tiruchirappalli,Rural,74390,287702,141797,145905
33,614,DISTRICT,Tiruchirappalli,Urban,43914,178859,88993,89866
33,615,DISTRICT,Perambalur  ,Total,45612,175289,87444,87845
33,615,DISTRICT,Perambalur  ,Rural,39026,150504,75254,75250
33,615,DISTRICT,Perambalur  ,Urban,6586,24785,12190,12595
33,616,DISTRICT,Ariyalur  ,Total,42774,176230,88076,88154
33,616,DISTRICT,Ariyalur  ,Rural,39843,163770,81857,81913
33,616,DISTRICT,Ariyalur  ,Urban,2931,12460,6219,6241
33,617,DISTRICT,Cuddalore,Total,180478,763944,383943,380001
33,617,DISTRICT,Cuddalore,Rural,145592,609922,307009,302913
33,617,DISTRICT,Cuddalore,Urban,34886,154022,76934,77088
33,618,DISTRICT,Nagapattinam  ,Total,128508,509767,252332,257435
33,618,DISTRICT,Nagapattinam  ,Rural,116484,459236,227905,231331
33,618,DISTRICT,Nagapattinam  ,Urban,12024,50531,24427,26104
33,619,DISTRICT,Thiruvarur,Total,110247,430927,214717,216210
33,619,DISTRICT,Thiruvarur,Rural,99869,388740,193888,194852
33,619,DISTRICT,Thiruvarur,Urban,10378,42187,20829,21358
33,620,DISTRICT,Thanjavur,Total,109518,455062,225859,229203
33,620,DISTRICT,Thanjavur,Rural,90089,371394,184536,186858
33,620,DISTRICT,Thanjavur,Urban,19429,83668,41323,42345
33,621,DISTRICT,Pudukkottai,Total,67188,284804,141428,143376
33,621,DISTRICT,Pudukkottai,Rural,58308,246531,122184,124347
33,621,DISTRICT,Pudukkottai,Urban,8880,38273,19244,19029
33,622,DISTRICT,Sivaganga,Total,56716,227746,113599,114147
33,622,DISTRICT,Sivaganga,Rural,46234,184829,92228,92601
33,622,DISTRICT,Sivaganga,Urban,10482,42917,21371,21546
33,623,DISTRICT,Madurai,Total,103274,408976,205098,203878
33,623,DISTRICT,Madurai,Rural,66081,257852,129515,128337
33,623,DISTRICT,Madurai,Urban,37193,151124,75583,75541
33,624,DISTRICT,Theni  ,Total,65605,258200,129900,128300
33,624,DISTRICT,Theni  ,Rural,36965,143589,72599,70990
33,624,DISTRICT,Theni  ,Urban,28640,114611,57301,57310
33,625,DISTRICT,Virudhunagar,Total,106932,399831,198704,201127
33,625,DISTRICT,Virudhunagar,Rural,70764,263206,131286,131920
33,625,DISTRICT,Virudhunagar,Urban,36168,136625,67418,69207
33,626,DISTRICT,Ramanathapuram,Total,61185,249008,125015,123993
33,626,DISTRICT,Ramanathapuram,Rural,51225,205328,102954,102374
33,626,DISTRICT,Ramanathapuram,Urban,9960,43680,22061,21619
33,627,DISTRICT,Thoothukkudi,Total,89969,347895,172663,175232
33,627,DISTRICT,Thoothukkudi,Rural,60491,230895,114573,116322
33,627,DISTRICT,Thoothukkudi,Urban,29478,117000,58090,58910
33,628,DISTRICT,Tirunelveli ,Total,151954,569714,279570,290144
33,628,DISTRICT,Tirunelveli ,Rural,93904,345247,169385,175862
33,628,DISTRICT,Tirunelveli ,Urban,58050,224467,110185,114282
33,629,DISTRICT,Kanniyakumari,Total,19546,74249,36817,37432
33,629,DISTRICT,Kanniyakumari,Rural,5177,18972,9458,9514
33,629,DISTRICT,Kanniyakumari,Urban,14369,55277,27359,27918
33,630,DISTRICT,Dharmapuri,Total,58028,245392,124706,120686
33,630,DISTRICT,Dharmapuri,Rural,48960,207187,105556,101631
33,630,DISTRICT,Dharmapuri,Urban,9068,38205,19150,19055
33,631,DISTRICT,Krishnagiri,Total,60868,267386,135474,131912
33,631,DISTRICT,Krishnagiri,Rural,49701,217822,110438,107384
33,631,DISTRICT,Krishnagiri,Urban,11167,49564,25036,24528
33,632,DISTRICT,Coimbatore,Total,145518,535911,266960,268951
33,632,DISTRICT,Coimbatore,Rural,52431,187055,93037,94018
33,632,DISTRICT,Coimbatore,Urban,93087,348856,173923,174933
33,633,DISTRICT,Tiruppur,Total,112982,395876,196907,198969
33,633,DISTRICT,Tiruppur,Rural,69533,237893,118360,119533
33,633,DISTRICT,Tiruppur,Urban,43449,157983,78547,79436
34,0,State,PUDUCHERRY,Total,45409,196325,95512,100813
34,0,State,PUDUCHERRY,Rural,25297,110425,53793,56632
34,0,State,PUDUCHERRY,Urban,20112,85900,41719,44181
34,634,DISTRICT,Yanam,Total,2112,8427,4100,4327
34,634,DISTRICT,Yanam,Rural,0,0,0,0
34,634,DISTRICT,Yanam,Urban,2112,8427,4100,4327
34,635,DISTRICT,Puducherry,Total,34378,152406,74129,78277
34,635,DISTRICT,Puducherry,Rural,19048,85624,41680,43944
34,635,DISTRICT,Puducherry,Urban,15330,66782,32449,34333
34,636,DISTRICT,Mahe,Total,31,144,77,67
34,636,DISTRICT,Mahe,Rural,0,0,0,0
34,636,DISTRICT,Mahe,Urban,31,144,77,67
34,637,DISTRICT,Karaikal,Total,8888,35348,17206,18142
34,637,DISTRICT,Karaikal,Rural,6249,24801,12113,12688
34,637,DISTRICT,Karaikal,Urban,2639,10547,5093,5454
